County,AUN,LEA,School Code,School,Oct 1 Enrollment Grades 7-12,Male Dropouts,Female Dropouts,Dropouts,Dropout Rate
Adams,112011103,Bermudian Springs SD,0003,Bermudian Springs HS,597,2,3,5,0.84%
Adams,112011103,Bermudian Springs SD,6921,Bermudian Springs MS,323,0,0,0,0.00%
Adams,112011603,Conewago Valley SD,9999,Conewago Valley SD,12,1,0,1,8.33%
Adams,112011603,Conewago Valley SD,6898,New Oxford MS,634,0,0,0,0.00%
Adams,112011603,Conewago Valley SD,0017,New Oxford SHS,"1,227",13,10,23,1.87%
Adams,112013054,Fairfield Area SD,6269,Fairfield Area HS,324,3,0,3,0.93%
Adams,112013054,Fairfield Area SD,7322,Fairfield Area MS,142,0,0,0,0.00%
Adams,112013054,Fairfield Area SD,9999,Fairfield Area SD,3,0,0,0,0.00%
Adams,112013753,Gettysburg Area SD,6271,Gettysburg Area HS,"1,141",5,3,8,0.70%
Adams,112013753,Gettysburg Area SD,0010,Gettysburg Area MS,524,0,0,0,0.00%
Adams,112013753,Gettysburg Area SD,9999,Gettysburg Area SD,3,0,0,0,0.00%
Adams,112015203,Littlestown Area SD,9999,Littlestown Area SD,9,0,0,0,0.00%
Adams,112015203,Littlestown Area SD,0014,Littlestown SHS,594,1,3,4,0.67%
Adams,112015203,Littlestown Area SD,0013,Maple Avenue MS,310,0,1,1,0.32%
Adams,112018523,Upper Adams SD,0018,Arendtsville El Sch,4,0,0,0,0.00%
Adams,112018523,Upper Adams SD,0021,Biglerville HS,521,6,1,7,1.34%
Adams,112018523,Upper Adams SD,7437,Upper Adams MS,293,0,0,0,0.00%
Adams,112018523,Upper Adams SD,9999,Upper Adams SD,5,0,0,0,0.00%
Allegheny,103020603,Allegheny Valley SD,9999,Allegheny Valley SD,14,0,0,0,0.00%
Allegheny,103020603,Allegheny Valley SD,0029,Springdale JSHS,397,0,1,1,0.25%
Allegheny,103020753,Avonworth SD,5199,Avonworth HS,493,1,2,3,0.61%
Allegheny,103020753,Avonworth SD,7669,Avonworth MS,298,0,0,0,0.00%
Allegheny,103020753,Avonworth SD,9999,Avonworth SD,6,0,0,0,0.00%
Allegheny,103021102,Baldwin-Whitehall SD,0050,Baldwin SHS,"1,504",4,2,6,0.40%
Allegheny,103021102,Baldwin-Whitehall SD,9999,Baldwin-Whitehall SD,17,0,0,0,0.00%
Allegheny,103021102,Baldwin-Whitehall SD,6787,Harrison MS,633,0,0,0,0.00%
Allegheny,103021252,Bethel Park SD,0062,Bethel Park HS,"1,381",4,4,8,0.58%
Allegheny,103021252,Bethel Park SD,0061,Independence MS,632,0,0,0,0.00%
Allegheny,103021453,Brentwood Borough SD,9999,Brentwood Borough SD,3,0,0,0,0.00%
Allegheny,103021453,Brentwood Borough SD,7342,Brentwood MS,187,0,0,0,0.00%
Allegheny,103021453,Brentwood Borough SD,0070,Brentwood SHS,383,1,0,1,0.26%
Allegheny,103021603,Carlynton SD,0079,Carlynton JSHS,596,3,2,5,0.84%
Allegheny,103021603,Carlynton SD,9999,Carlynton SD,9,0,0,0,0.00%
Allegheny,103021752,Chartiers Valley SD,6706,Chartiers Valley HS,998,0,1,1,0.10%
Allegheny,103021752,Chartiers Valley SD,0094,Chartiers Valley MS,463,0,0,0,0.00%
Allegheny,103021752,Chartiers Valley SD,9999,Chartiers Valley SD,8,0,0,0,0.00%
Allegheny,102020001,City CHS,7727,City CHS,552,2,1,3,0.54%
Allegheny,103021903,Clairton City SD,9999,Clairton City SD,1,0,0,0,0.00%
Allegheny,103021903,Clairton City SD,8094,Clairton MS/HS,310,1,0,1,0.32%
Allegheny,103022103,Cornell SD,8087,Cornell HS,268,4,2,6,2.24%
Allegheny,103022103,Cornell SD,9999,Cornell SD,4,1,0,1,25.00%
Allegheny,103022253,Deer Lakes SD,0513,Deer Lakes HS,567,2,1,3,0.53%
Allegheny,103022253,Deer Lakes SD,7595,Deer Lakes MS,293,0,0,0,0.00%
Allegheny,103022253,Deer Lakes SD,9999,Deer Lakes SD,33,0,0,0,0.00%
Allegheny,103022803,East Allegheny SD,8340,East Allegheny JSHS,749,3,1,4,0.53%
Allegheny,103022803,East Allegheny SD,9999,East Allegheny SD,14,0,0,0,0.00%
Allegheny,103023153,Elizabeth Forward SD,4804,Elizabeth Forward MS,376,0,0,0,0.00%
Allegheny,103023153,Elizabeth Forward SD,9999,Elizabeth Forward SD,3,0,0,0,0.00%
Allegheny,103023153,Elizabeth Forward SD,0144,Elizabeth Forward SHS,686,1,1,2,0.29%
Allegheny,199025446,Environmental CS at Frick Park,8028,Environmental Charter School at Frick Pa,190,0,0,0,0.00%
Allegheny,103023912,Fox Chapel Area SD,0147,Dorseyville MS,615,0,0,0,0.00%
Allegheny,103023912,Fox Chapel Area SD,0156,Fox Chapel Area HS,"1,333",2,0,2,0.15%
Allegheny,103023912,Fox Chapel Area SD,9999,Fox Chapel Area SD,4,1,0,1,25.00%
Allegheny,103024102,Gateway SD,0167,Gateway MS,561,1,0,1,0.18%
Allegheny,103024102,Gateway SD,0170,Gateway SHS,"1,088",7,3,10,0.92%
Allegheny,103024603,Hampton Township SD,5190,Hampton HS,949,2,2,4,0.42%
Allegheny,103024603,Hampton Township SD,0179,Hampton MS,441,0,0,0,0.00%
Allegheny,103024603,Hampton Township SD,9999,Hampton Township SD,3,0,0,0,0.00%
Allegheny,103024753,Highlands SD,7202,Highlands MS,384,0,0,0,0.00%
Allegheny,103024753,Highlands SD,9999,Highlands SD,9,1,0,1,11.11%
Allegheny,103024753,Highlands SD,5153,Highlands SHS,720,22,7,29,4.03%
Allegheny,103025002,Keystone Oaks SD,5112,Keystone Oaks HS,571,0,2,2,0.35%
Allegheny,103025002,Keystone Oaks SD,7462,Keystone Oaks MS,312,0,0,0,0.00%
Allegheny,103025002,Keystone Oaks SD,9999,Keystone Oaks SD,16,0,0,0,0.00%
Allegheny,102023030,Manchester Academic CS,7549,Manchester Academic CS,74,0,0,0,0.00%
Allegheny,103026002,McKeesport Area SD,7673,Founders Hall Middle Sch,511,0,0,0,0.00%
Allegheny,103026002,McKeesport Area SD,6105,McKeesport Area SHS,"1,005",29,21,50,4.98%
Allegheny,103026303,Montour SD,8177,David E Williams MS,425,0,0,0,0.00%
Allegheny,103026303,Montour SD,5017,Montour HS,928,0,1,1,0.11%
Allegheny,103026303,Montour SD,9999,Montour SD,7,0,0,0,0.00%
Allegheny,103026343,Moon Area SD,9999,Moon Area SD,14,1,0,1,7.14%
Allegheny,103026343,Moon Area SD,8254,Moon Area Upper MS,626,0,0,0,0.00%
Allegheny,103026343,Moon Area SD,4951,Moon SHS,"1,178",3,2,5,0.42%
Allegheny,103026402,Mt Lebanon SD,7535,Jefferson MS,437,0,0,0,0.00%
Allegheny,103026402,Mt Lebanon SD,7534,Mellon MS,445,0,0,0,0.00%
Allegheny,103026402,Mt Lebanon SD,9999,Mt Lebanon SD,10,0,0,0,0.00%
Allegheny,103026402,Mt Lebanon SD,0254,Mt Lebanon SHS,"1,792",0,0,0,0.00%
Allegheny,103026852,North Allegheny SD,5108,Carson MS,470,0,0,0,0.00%
Allegheny,103026852,North Allegheny SD,0270,Ingomar MS,340,0,0,0,0.00%
Allegheny,103026852,North Allegheny SD,7379,Marshall MS,547,0,0,0,0.00%
Allegheny,103026852,North Allegheny SD,8305,North Allegheny HS,"2,690",0,0,0,0.00%
Allegheny,103026852,North Allegheny SD,9999,North Allegheny SD,56,1,0,1,1.79%
Allegheny,103026902,North Hills SD,6106,North Hills MS,709,0,0,0,0.00%
Allegheny,103026902,North Hills SD,7101,North Hills SHS,"1,279",2,1,3,0.23%
Allegheny,103026873,Northgate SD,0053,Northgate MSHS,446,4,2,6,1.35%
Allegheny,103026873,Northgate SD,9999,Northgate SD,6,0,0,0,0.00%
Allegheny,102023217,Passport Academy CS,8308,Passport Academy CS,167,25,29,54,32.34%
Allegheny,103022481,Penn Hills CS of Entrepreneurship,8160,Penn Hills Charter School of Entrepreneu,94,0,0,0,0.00%
Allegheny,103027352,Penn Hills SD,5019,Linton MS,510,0,0,0,0.00%
Allegheny,103027352,Penn Hills SD,0309,Penn Hills SHS,"1,137",4,6,10,0.88%
Allegheny,115220003,Pennsylvania Distance Learning CS,7821,Pennsylvania Distance Learning CS,537,25,21,46,8.57%
Allegheny,103021003,Pine-Richland SD,0315,Pine-Richland HS,"1,463",2,1,3,0.21%
Allegheny,103021003,Pine-Richland SD,0314,Pine-Richland MS,718,0,0,0,0.00%
Allegheny,103021003,Pine-Richland SD,9999,Pine-Richland SD,17,0,0,0,0.00%
Allegheny,102027451,Pittsburgh SD,8203,Academy at Westinghouse,640,8,6,14,2.19%
Allegheny,102027451,Pittsburgh SD,0409,Pittsburgh Allderdice HS,"1,468",13,6,19,1.29%
Allegheny,102027451,Pittsburgh SD,7616,Pittsburgh Allegheny 6-8,111,0,0,0,0.00%
Allegheny,102027451,Pittsburgh SD,7878,Pittsburgh Arlington K-8,83,1,1,2,2.41%
Allegheny,102027451,Pittsburgh SD,7886,Pittsburgh Arsenal 6-8,119,0,0,0,0.00%
Allegheny,102027451,Pittsburgh SD,6915,Pittsburgh Brashear HS,"1,184",26,9,35,2.96%
Allegheny,102027451,Pittsburgh SD,7868,Pittsburgh Brookline K-8,93,0,0,0,0.00%
Allegheny,102027451,Pittsburgh SD,8106,Pittsburgh CAPA 6-12,753,0,0,0,0.00%
Allegheny,102027451,Pittsburgh SD,0326,Pittsburgh Carmalt K-8,82,0,0,0,0.00%
Allegheny,102027451,Pittsburgh SD,0412,Pittsburgh Carrick HS,700,14,10,24,3.43%
Allegheny,102027451,Pittsburgh SD,7692,Pittsburgh Classical 6-8,180,0,0,0,0.00%
Allegheny,102027451,Pittsburgh SD,6022,Pittsburgh Colfax K-8,152,0,0,0,0.00%
Allegheny,102027451,Pittsburgh SD,6811,Pittsburgh Conroy,124,0,1,1,0.81%
Allegheny,102027451,Pittsburgh SD,6028,Pittsburgh Greenfield K-8,81,0,0,0,0.00%
Allegheny,102027451,Pittsburgh SD,7880,Pittsburgh King K-8,58,0,0,0,0.00%
Allegheny,102027451,Pittsburgh SD,8255,Pittsburgh Langley K-8,111,0,0,0,0.00%
Allegheny,102027451,Pittsburgh SD,7871,Pittsburgh Manchester K-8,43,0,0,0,0.00%
Allegheny,102027451,Pittsburgh SD,7881,Pittsburgh Mifflin K-8,71,0,0,0,0.00%
Allegheny,102027451,Pittsburgh SD,8110,Pittsburgh Milliones 6-12,291,5,1,6,2.06%
Allegheny,102027451,Pittsburgh SD,0365,Pittsburgh Morrow K-8,116,0,1,1,0.86%
Allegheny,102027451,Pittsburgh SD,8105,Pittsburgh Obama 6-12,726,0,0,0,0.00%
Allegheny,102027451,Pittsburgh SD,6047,Pittsburgh Oliver,73,0,1,1,1.37%
Allegheny,102027451,Pittsburgh SD,8300,Pittsburgh Online Academy,98,0,0,0,0.00%
Allegheny,102027451,Pittsburgh SD,0416,Pittsburgh Perry HS,361,6,6,12,3.32%
Allegheny,102027451,Pittsburgh SD,6664,Pittsburgh Pioneer,36,0,0,0,0.00%
Allegheny,102027451,Pittsburgh SD,0379,Pittsburgh Schiller 6-8,140,0,0,0,0.00%
Allegheny,102027451,Pittsburgh SD,8107,Pittsburgh Science and Technology Academ,535,1,0,1,0.19%
Allegheny,102027451,Pittsburgh SD,9999,Pittsburgh SD,313,0,1,1,0.32%
Allegheny,102027451,Pittsburgh SD,7693,Pittsburgh South Brook 6-8,233,0,0,0,0.00%
Allegheny,102027451,Pittsburgh SD,7888,Pittsburgh South Hills 6-8,275,0,0,0,0.00%
Allegheny,102027451,Pittsburgh SD,7039,Pittsburgh Sterrett 6-8,202,0,0,0,0.00%
Allegheny,102027451,Pittsburgh SD,7884,Pittsburgh Sunnyside K-8,61,0,0,0,0.00%
Allegheny,103027503,Plum Borough SD,8354,Holiday Park El Sch,2,0,0,0,0.00%
Allegheny,103027503,Plum Borough SD,5105,Oblock JHS,591,0,0,0,0.00%
Allegheny,103027503,Plum Borough SD,9999,Plum Borough SD,7,0,0,0,0.00%
Allegheny,103027503,Plum Borough SD,0435,Plum SHS,"1,162",4,1,5,0.43%
Allegheny,160028259,Propel CS-Braddock Hills,8129,Propel CS-Braddock Hills,437,5,1,6,1.37%
Allegheny,160028259,Propel CS-Braddock Hills,9999,Propel CS-Braddock Hills,1,0,0,0,0.00%
Allegheny,103020005,Propel CS-East,7848,Propel CS-East,81,0,0,0,0.00%
Allegheny,103024952,Propel CS-Hazelwood,9999,Propel CS-Hazelwood,1,0,0,0,0.00%
Allegheny,103024952,Propel CS-Hazelwood,8306,Propel CS-Hazelwood,56,0,0,0,0.00%
Allegheny,103020002,Propel CS-Homestead,7772,Propel CS-Homestead,252,3,0,3,1.19%
Allegheny,103020003,Propel CS-McKeesport,7831,Propel CS-McKeesport,85,0,0,0,0.00%
Allegheny,103020004,Propel CS-Montour,7832,Propel CS-Montour,282,1,0,1,0.35%
Allegheny,103020004,Propel CS-Montour,9999,Propel CS-Montour,2,0,0,0,0.00%
Allegheny,103028192,Propel CS-Northside,8193,Propel CS-Northside,74,0,1,1,1.35%
Allegheny,103024162,Propel CS-Pitcairn,8218,Propel CS-Pitcairn,76,0,0,0,0.00%
Allegheny,102027560,Provident CS,8362,Provident CS,44,0,0,0,0.00%
Allegheny,103027753,Quaker Valley SD,0448,Quaker Valley HS,629,0,0,0,0.00%
Allegheny,103027753,Quaker Valley SD,0447,Quaker Valley MS,309,0,0,0,0.00%
Allegheny,103027753,Quaker Valley SD,9999,Quaker Valley SD,4,0,0,0,0.00%
Allegheny,103028203,Riverview SD,6928,Riverview JSHS,428,0,2,2,0.47%
Allegheny,103028203,Riverview SD,9999,Riverview SD,6,0,0,0,0.00%
Allegheny,103028302,Shaler Area SD,0460,Shaler Area HS,"1,296",3,4,7,0.54%
Allegheny,103028302,Shaler Area SD,8002,Shaler Area MS,597,0,0,0,0.00%
Allegheny,103028302,Shaler Area SD,9999,Shaler Area SD,11,1,0,1,9.09%
Allegheny,103028653,South Allegheny SD,8459,South Allegheny HS,492,4,6,10,2.03%
Allegheny,103028653,South Allegheny SD,8460,South Allegheny MS,259,1,1,2,0.77%
Allegheny,103028653,South Allegheny SD,9999,South Allegheny SD,6,1,0,1,16.67%
Allegheny,103028703,South Fayette Township SD,7490,South Fayette MS,595,0,0,0,0.00%
Allegheny,103028703,South Fayette Township SD,9999,South Fayette Township SD,6,0,0,0,0.00%
Allegheny,103028703,South Fayette Township SD,0470,South Fayette Twp HS,"1,011",0,0,0,0.00%
Allegheny,103028753,South Park SD,6906,South Park MS,269,0,0,0,0.00%
Allegheny,103028753,South Park SD,9999,South Park SD,4,0,0,0,0.00%
Allegheny,103028753,South Park SD,0467,South Park SHS,584,2,2,4,0.68%
Allegheny,103023410,Spectrum CS,7648,Spectrum CS,32,0,0,0,0.00%
Allegheny,103028833,Steel Valley SD,0260,Steel Valley MS,191,0,0,0,0.00%
Allegheny,103028833,Steel Valley SD,0196,Steel Valley SHS,437,0,0,0,0.00%
Allegheny,103028853,Sto-Rox SD,0477,Sto-Rox JSHS,520,4,6,10,1.92%
Allegheny,103028853,Sto-Rox SD,9999,Sto-Rox SD,9,0,1,1,11.11%
Allegheny,102020003,The New Academy CS,7846,The New Academy CS,142,10,0,10,7.04%
Allegheny,103029203,Upper Saint Clair SD,0491,Fort Couch MS,658,0,0,0,0.00%
Allegheny,103029203,Upper Saint Clair SD,0492,Upper Saint Clair HS,"1,392",0,0,0,0.00%
Allegheny,103029203,Upper Saint Clair SD,9999,Upper Saint Clair SD,5,0,0,0,0.00%
Allegheny,102023080,Urban Pathways 6-12 CS,9999,Urban Pathways 6-12 CS,2,0,0,0,0.00%
Allegheny,102023080,Urban Pathways 6-12 CS,7562,Urban Pathways 6-12 CS,275,1,1,2,0.73%
Allegheny,103029403,West Allegheny SD,6895,West Allegheny MS,486,0,0,0,0.00%
Allegheny,103029403,West Allegheny SD,0509,West Allegheny SHS,"1,014",1,0,1,0.10%
Allegheny,103029553,West Jefferson Hills SD,4867,Pleasant Hills MS,463,0,0,0,0.00%
Allegheny,103029553,West Jefferson Hills SD,0523,Thomas Jefferson HS,917,1,1,2,0.22%
Allegheny,103029553,West Jefferson Hills SD,9999,West Jefferson Hills SD,11,0,0,0,0.00%
Allegheny,103029603,West Mifflin Area SD,0536,West Mifflin Area HS,956,11,4,15,1.57%
Allegheny,103029603,West Mifflin Area SD,0535,West Mifflin Area MS,487,0,0,0,0.00%
Allegheny,103029603,West Mifflin Area SD,9999,West Mifflin Area SD,9,0,0,0,0.00%
Allegheny,103028425,Westinghouse Arts Academy CS,8392,Westinghouse Arts Academy CS,216,2,0,2,0.93%
Allegheny,103029902,Woodland Hills SD,0107,Woodland Hills HS,"1,003",19,12,31,3.09%
Allegheny,103029902,Woodland Hills SD,8466,Woodland Hills Intermediate Sch,490,1,4,5,1.02%
Allegheny,103029902,Woodland Hills SD,9999,Woodland Hills SD,4,0,0,0,0.00%
Allegheny,103020368,Young Scholars of Greater Allegheny CS,8337,Young Scholars of McKeesport Charter Sch,23,0,0,0,0.00%
Allegheny,103025206,Young Scholars of Western Pennsylvania C,8156,Young Scholars of Western Pennsylvania C,58,0,0,0,0.00%
Armstrong,128030603,Apollo-Ridge SD,2320,Apollo-Ridge HS,317,2,2,4,1.26%
Armstrong,128030603,Apollo-Ridge SD,6570,Apollo-Ridge MS,197,0,0,0,0.00%
Armstrong,128030603,Apollo-Ridge SD,9999,Apollo-Ridge SD,20,1,1,2,10.00%
Armstrong,128030852,Armstrong SD,8342,Armstrong JSHS,"1,618",8,5,13,0.80%
Armstrong,128030852,Armstrong SD,9999,Armstrong SD,19,0,0,0,0.00%
Armstrong,128030852,Armstrong SD,7640,West Shamokin JSHS,609,2,3,5,0.82%
Armstrong,128033053,Freeport Area SD,8346,Freeport Area MS,291,0,0,0,0.00%
Armstrong,128033053,Freeport Area SD,9999,Freeport Area SD,4,1,0,1,25.00%
Armstrong,128033053,Freeport Area SD,0594,Freeport Area SHS,582,1,0,1,0.17%
Armstrong,128034503,Leechburg Area SD,7923,Leechburg Area HS,213,0,0,0,0.00%
Armstrong,128034503,Leechburg Area SD,8393,Leechburg Area MS,102,0,0,0,0.00%
Armstrong,128034503,Leechburg Area SD,9999,Leechburg Area SD,14,1,0,1,7.14%
Armstrong,128034607,Lenape Tech,4807,Lenape Tech,531,0,1,1,0.19%
Beaver,127040503,Aliquippa SD,8086,Aliquippa JSHS,405,1,1,2,0.49%
Beaver,127040703,Ambridge Area SD,6555,Ambridge Area HS,749,4,4,8,1.07%
Beaver,127040703,Ambridge Area SD,0633,Ambridge Area MS,370,0,0,0,0.00%
Beaver,127040703,Ambridge Area SD,9999,Ambridge Area SD,25,4,0,4,16.00%
Beaver,127041203,Beaver Area SD,7386,Beaver Area MS,302,0,0,0,0.00%
Beaver,127041203,Beaver Area SD,0640,Beaver Area SHS,694,1,0,1,0.14%
Beaver,127041503,Big Beaver Falls Area SD,0649,Beaver Falls Area SHS,458,6,8,14,3.06%
Beaver,127041503,Big Beaver Falls Area SD,0648,Beaver Falls MS,241,0,0,0,0.00%
Beaver,127041503,Big Beaver Falls Area SD,9999,Big Beaver Falls Area SD,12,1,0,1,8.33%
Beaver,127041603,Blackhawk SD,6707,Blackhawk HS,733,4,1,5,0.68%
Beaver,127041603,Blackhawk SD,9999,Blackhawk SD,6,0,0,0,0.00%
Beaver,127041603,Blackhawk SD,6558,Highland MS,385,0,0,0,0.00%
Beaver,127042003,Central Valley SD,8044,Central Valley HS,718,2,4,6,0.84%
Beaver,127042003,Central Valley SD,8043,Central Valley MS,371,1,0,1,0.27%
Beaver,127042853,Freedom Area SD,8356,Freedom Area MS,190,0,0,0,0.00%
Beaver,127042853,Freedom Area SD,9999,Freedom Area SD,6,0,0,0,0.00%
Beaver,127042853,Freedom Area SD,6563,Freedom Area SHS,426,2,1,3,0.70%
Beaver,127044103,Hopewell Area SD,9999,Hopewell Area SD,16,0,0,0,0.00%
Beaver,127044103,Hopewell Area SD,0674,Hopewell JHS,332,0,1,1,0.30%
Beaver,127044103,Hopewell Area SD,0675,Hopewell SHS,597,3,1,4,0.67%
Beaver,127040002,Lincoln Park Performing Arts CS,7859,Lincoln Park Performing Arts CS,790,0,0,0,0.00%
Beaver,127045303,Midland Borough SD,9999,Midland Borough SD,1,0,0,0,0.00%
Beaver,127045303,Midland Borough SD,6566,Midland El/MS,44,0,0,0,0.00%
Beaver,127045653,New Brighton Area SD,0695,New Brighton Area HS,419,3,3,6,1.43%
Beaver,127045653,New Brighton Area SD,0694,New Brighton Area MS,194,0,0,0,0.00%
Beaver,127045653,New Brighton Area SD,9999,New Brighton Area SD,8,0,0,0,0.00%
Beaver,127043430,Pennsylvania Cyber CS,9999,Pennsylvania Cyber CS,13,0,0,0,0.00%
Beaver,127043430,Pennsylvania Cyber CS,7650,Pennsylvania Cyber CS,"7,084",278,310,588,8.30%
Beaver,127045853,Riverside Beaver County SD,0700,Riverside HS,444,5,0,5,1.13%
Beaver,127045853,Riverside Beaver County SD,8188,Riverside MS,226,0,0,0,0.00%
Beaver,127046903,Rochester Area SD,9999,Rochester Area SD,10,0,0,0,0.00%
Beaver,127046903,Rochester Area SD,8000,Rochester High School,182,2,1,3,1.65%
Beaver,127046903,Rochester Area SD,8279,Rochester MS,119,1,0,1,0.84%
Beaver,127047404,South Side Area SD,0714,South Side HS,328,0,0,0,0.00%
Beaver,127047404,South Side Area SD,6937,South Side MS,155,0,0,0,0.00%
Beaver,127049303,Western Beaver County SD,0719,Western Beaver Co JSHS,310,0,2,2,0.65%
Beaver,127049303,Western Beaver County SD,9999,Western Beaver County SD,2,0,0,0,0.00%
Bedford,108051003,Bedford Area SD,7021,Bedford MS,294,1,1,2,0.68%
Bedford,108051003,Bedford Area SD,0726,Bedford SHS,599,3,6,9,1.50%
Bedford,108051503,Chestnut Ridge SD,0729,Chestnut Ridge MS,106,0,0,0,0.00%
Bedford,108051503,Chestnut Ridge SD,9999,Chestnut Ridge SD,2,0,0,0,0.00%
Bedford,108051503,Chestnut Ridge SD,0732,Chestnut Ridge SHS,536,1,0,1,0.19%
Bedford,108053003,Everett Area SD,7897,Everett Area HS,396,4,2,6,1.52%
Bedford,108053003,Everett Area SD,7898,Everett Area MS,176,0,0,0,0.00%
Bedford,108057079,HOPE for Hyndman CS,8154,HOPE for Hyndman CS,86,0,0,0,0.00%
Bedford,108056004,Northern Bedford County SD,8436,Northern Bedford County HS,279,0,1,1,0.36%
Bedford,108056004,Northern Bedford County SD,8435,Northern Bedford County MS,139,0,0,0,0.00%
Bedford,108058003,Tussey Mountain SD,0753,Tussey Mountain HS,258,2,0,2,0.78%
Bedford,108058003,Tussey Mountain SD,8411,Tussey Mountain MS,153,0,0,0,0.00%
Berks,114060503,Antietam SD,0820,Antietam MS/HS,487,2,9,11,2.26%
Berks,114060503,Antietam SD,9999,Antietam SD,16,0,1,1,6.25%
Berks,114060753,Boyertown Area SD,6804,Boyertown Area MS-East,611,0,0,0,0.00%
Berks,114060753,Boyertown Area SD,6305,Boyertown Area MS-West,520,0,0,0,0.00%
Berks,114060753,Boyertown Area SD,6306,Boyertown Area SHS,"2,152",7,3,10,0.46%
Berks,114060853,Brandywine Heights Area SD,9999,Brandywine Heights Area SD,6,0,0,0,0.00%
Berks,114060853,Brandywine Heights Area SD,6308,Brandywine Heights HS,482,3,3,6,1.24%
Berks,114060853,Brandywine Heights Area SD,8383,Brandywine Heights Intrmd/MS,232,0,0,0,0.00%
Berks,114061103,Conrad Weiser Area SD,9999,Conrad Weiser Area SD,55,0,2,2,3.64%
Berks,114061103,Conrad Weiser Area SD,0777,Conrad Weiser HS,848,3,3,6,0.71%
Berks,114061103,Conrad Weiser Area SD,7651,Conrad Weiser MS,429,0,0,0,0.00%
Berks,114061503,Daniel Boone Area SD,4810,Daniel Boone Area HS,"1,098",9,4,13,1.18%
Berks,114061503,Daniel Boone Area SD,7544,Daniel Boone Area MS,538,0,0,0,0.00%
Berks,114061503,Daniel Boone Area SD,9999,Daniel Boone Area SD,21,1,0,1,4.76%
Berks,114062003,Exeter Township SD,9999,Exeter Township SD,7,0,0,0,0.00%
Berks,114062003,Exeter Township SD,0787,Exeter Twp JHS,581,0,0,0,0.00%
Berks,114062003,Exeter Township SD,0788,Exeter Twp SHS,"1,303",6,4,10,0.77%
Berks,114062503,Fleetwood Area SD,9999,Fleetwood Area SD,8,0,0,0,0.00%
Berks,114062503,Fleetwood Area SD,6311,Fleetwood MS,395,0,0,0,0.00%
Berks,114062503,Fleetwood Area SD,5023,Fleetwood SHS,847,0,1,1,0.12%
Berks,114063003,Governor Mifflin SD,0801,Governor Mifflin MS,723,0,0,0,0.00%
Berks,114063003,Governor Mifflin SD,0802,Governor Mifflin SHS,"1,447",12,2,14,0.97%
Berks,114063503,Hamburg Area SD,0808,Hamburg Area HS,682,5,2,7,1.03%
Berks,114063503,Hamburg Area SD,7447,Hamburg Area Middle School,354,0,0,0,0.00%
Berks,114063503,Hamburg Area SD,9999,Hamburg Area SD,16,0,0,0,0.00%
Berks,114063503,Hamburg Area SD,0809,Perry El Sch,2,0,0,0,0.00%
Berks,114060392,I-LEAD Charter School,8155,I-LEAD Charter School,408,26,34,60,14.71%
Berks,114064003,Kutztown Area SD,6315,Kutztown Area MS,221,0,0,0,0.00%
Berks,114064003,Kutztown Area SD,9999,Kutztown Area SD,3,0,0,0,0.00%
Berks,114064003,Kutztown Area SD,0816,Kutztown Area SHS,444,7,3,10,2.25%
Berks,114065503,Muhlenberg SD,6610,Muhlenberg HS,988,7,1,8,0.81%
Berks,114065503,Muhlenberg SD,0827,Muhlenberg MS,"1,010",0,1,1,0.10%
Berks,114065503,Muhlenberg SD,9999,Muhlenberg SD,11,0,0,0,0.00%
Berks,114066503,Oley Valley SD,6319,Oley Valley MS,244,0,0,0,0.00%
Berks,114066503,Oley Valley SD,9999,Oley Valley SD,16,0,1,1,6.25%
Berks,114066503,Oley Valley SD,6318,Oley Valley SHS,553,0,0,0,0.00%
Berks,114067002,Reading SD,8117,Central MS,966,6,10,16,1.66%
Berks,114067002,Reading SD,0858,Northeast MS,553,1,1,2,0.36%
Berks,114067002,Reading SD,0856,Northwest MS,438,1,0,1,0.23%
Berks,114067002,Reading SD,9999,Reading SD,98,3,0,3,3.06%
Berks,114067002,Reading SD,8116,Reading SHS,"4,724",158,118,276,5.84%
Berks,114067002,Reading SD,0855,Southern MS,340,2,2,4,1.18%
Berks,114067002,Reading SD,8457,Southwest MS,347,3,5,8,2.31%
Berks,114067503,Schuylkill Valley SD,0864,Schuylkill Valley HS,625,3,1,4,0.64%
Berks,114067503,Schuylkill Valley SD,6888,Schuylkill Valley MS,333,0,0,0,0.00%
Berks,114067503,Schuylkill Valley SD,9999,Schuylkill Valley SD,12,0,0,0,0.00%
Berks,114068003,Tulpehocken Area SD,9999,Tulpehocken Area SD,6,0,0,0,0.00%
Berks,114068003,Tulpehocken Area SD,4670,Tulpehocken JSHS,683,6,1,7,1.02%
Berks,114068103,Twin Valley SD,0873,Twin Valley HS,"1,036",7,2,9,0.87%
Berks,114068103,Twin Valley SD,7328,Twin Valley MS,513,0,0,0,0.00%
Berks,114068103,Twin Valley SD,9999,Twin Valley SD,7,0,1,1,14.29%
Berks,114069103,Wilson SD,6980,Wilson HS,"1,983",4,3,7,0.35%
Berks,114069103,Wilson SD,9999,Wilson SD,2,0,0,0,0.00%
Berks,114069103,Wilson SD,6982,Wilson Southern MS,511,0,0,0,0.00%
Berks,114069103,Wilson SD,6981,Wilson West MS,491,2,0,2,0.41%
Berks,114069353,Wyomissing Area SD,0887,Wyomissing Area JSHS,904,3,3,6,0.66%
Berks,114069353,Wyomissing Area SD,9999,Wyomissing Area SD,13,0,0,0,0.00%
Blair,108070502,Altoona Area SD,0913,Altoona Area HS,"1,663",39,20,59,3.55%
Blair,108070502,Altoona Area SD,7986,Altoona Area Jr HS,"1,697",0,0,0,0.00%
Blair,108070502,Altoona Area SD,9999,Altoona Area SD,1,0,0,0,0.00%
Blair,108070502,Altoona Area SD,7425,Kimmel Alternative School,24,3,1,4,16.67%
Blair,108071003,Bellwood-Antis SD,7144,Bellwood Antis MS,213,0,0,0,0.00%
Blair,108071003,Bellwood-Antis SD,0917,Bellwood-Antis HS,388,1,1,2,0.52%
Blair,108071003,Bellwood-Antis SD,9999,Bellwood-Antis SD,1,0,0,0,0.00%
Blair,108070001,Central PA Digital Learning Foundation C,7720,Central PA Digital Lrng Foundation CS,112,4,0,4,3.57%
Blair,108071504,Claysburg-Kimmel SD,0921,Claysburg-Kimmel HS,401,0,0,0,0.00%
Blair,108073503,Hollidaysburg Area SD,0927,Hollidaysburg Area JHS,808,0,0,0,0.00%
Blair,108073503,Hollidaysburg Area SD,9999,Hollidaysburg Area SD,8,1,0,1,12.50%
Blair,108073503,Hollidaysburg Area SD,5207,Hollidaysburg Area SHS,838,4,7,11,1.31%
Blair,108077503,Spring Cove SD,0941,Central HS,569,2,1,3,0.53%
Blair,108077503,Spring Cove SD,5130,Spring Cove MS,287,0,0,0,0.00%
Blair,108077503,Spring Cove SD,9999,Spring Cove SD,6,0,0,0,0.00%
Blair,108078003,Tyrone Area SD,0949,Tyrone Area HS,561,2,1,3,0.53%
Blair,108078003,Tyrone Area SD,7518,Tyrone Area MS,278,1,1,2,0.72%
Blair,108079004,Williamsburg Community SD,0950,Williamsburg Community El Sch,2,0,0,0,0.00%
Blair,108079004,Williamsburg Community SD,0951,Williamsburg Community JSHS,232,1,0,1,0.43%
Bradford,117080503,Athens Area SD,0958,Athens Area HS,647,2,2,4,0.62%
Bradford,117080503,Athens Area SD,8220,Harlan Rowe MS,357,0,0,0,0.00%
Bradford,117081003,Canton Area SD,0988,Canton JSHS,439,2,0,2,0.46%
Bradford,117083004,Northeast Bradford SD,0964,Northeast Bradford JSHS,366,2,1,3,0.82%
Bradford,117086003,Sayre Area SD,0965,Sayre Area HS,480,0,2,2,0.42%
Bradford,117086503,Towanda Area SD,5208,Towanda Area JSHS,651,5,2,7,1.08%
Bradford,117086653,Troy Area SD,1000,Troy Area JSHS,650,4,3,7,1.08%
Bradford,117089003,Wyalusing Area SD,9999,Wyalusing Area SD,1,0,0,0,0.00%
Bradford,117089003,Wyalusing Area SD,1005,Wyalusing Valley JSHS,618,2,3,5,0.81%
Bucks,122091002,Bensalem Township SD,9999,Bensalem Township SD,32,2,1,3,9.38%
Bucks,122091002,Bensalem Township SD,5116,Bensalem Twp HS,"2,001",26,18,44,2.20%
Bucks,122091002,Bensalem Township SD,6451,Cecelia Snyder MS,447,1,0,1,0.22%
Bucks,122091002,Bensalem Township SD,7030,Robert K Shafer MS,585,1,0,1,0.17%
Bucks,122091303,Bristol Borough SD,9999,Bristol Borough SD,3,0,0,0,0.00%
Bucks,122091303,Bristol Borough SD,1014,Bristol HS,291,1,0,1,0.34%
Bucks,122091303,Bristol Borough SD,7743,Bristol MS,225,0,0,0,0.00%
Bucks,122091352,Bristol Township SD,9999,Bristol Township SD,37,2,1,3,8.11%
Bucks,122091352,Bristol Township SD,8407,Neil A Armstrong MS,574,0,0,0,0.00%
Bucks,122091352,Bristol Township SD,1027,Roosevelt MS,511,0,0,0,0.00%
Bucks,122091352,Bristol Township SD,1029,Truman SHS,"1,582",16,10,26,1.64%
Bucks,122091457,Bucks County Technical High School,1030,Bucks County Technical High School,"1,459",1,0,1,0.07%
Bucks,122092002,Centennial SD,9999,Centennial SD,10,0,0,0,0.00%
Bucks,122092002,Centennial SD,7271,Klinger MS,470,0,0,0,0.00%
Bucks,122092002,Centennial SD,7274,Log College MS,432,1,0,1,0.23%
Bucks,122092002,Centennial SD,1040,William Tennent HS,"1,770",5,5,10,0.56%
Bucks,122090001,Center for Student Learning CS at Pennsb,7726,Center for Student Lrng CS Pennsbury,157,1,3,4,2.55%
Bucks,122092102,Central Bucks SD,5133,Central Bucks HS-East,"1,517",1,0,1,0.07%
Bucks,122092102,Central Bucks SD,7790,Central Bucks HS-South,"1,724",4,2,6,0.35%
Bucks,122092102,Central Bucks SD,1043,Central Bucks HS-West,"1,503",6,2,8,0.53%
Bucks,122092102,Central Bucks SD,9999,Central Bucks SD,75,0,0,0,0.00%
Bucks,122092102,Central Bucks SD,5307,Holicong MS,994,0,0,0,0.00%
Bucks,122092102,Central Bucks SD,1041,Lenape MS,897,0,0,0,0.00%
Bucks,122092102,Central Bucks SD,1042,Tamanend MS,852,0,0,0,0.00%
Bucks,122092102,Central Bucks SD,7715,Tohickon MS,909,0,0,0,0.00%
Bucks,122092102,Central Bucks SD,4678,Unami MS,875,0,0,0,0.00%
Bucks,122092353,Council Rock SD,5096,Council Rock HS North,"1,605",3,0,3,0.19%
Bucks,122092353,Council Rock SD,7749,Council Rock HS South,"2,021",3,0,3,0.15%
Bucks,122092353,Council Rock SD,9999,Council Rock SD,7,0,1,1,14.29%
Bucks,122092353,Council Rock SD,8447,Holland MS,950,0,0,0,0.00%
Bucks,122092353,Council Rock SD,6453,Newtown MS,814,0,0,0,0.00%
Bucks,122097203,Morrisville Borough SD,8381,Morrisville HS,371,1,1,2,0.54%
Bucks,122097502,Neshaminy SD,7380,Maple Point MS,679,0,0,0,0.00%
Bucks,122097502,Neshaminy SD,6455,Neshaminy HS,"2,611",18,6,24,0.92%
Bucks,122097502,Neshaminy SD,9999,Neshaminy SD,46,1,1,2,4.35%
Bucks,122097502,Neshaminy SD,1077,Poquessing MS,451,0,0,0,0.00%
Bucks,122097502,Neshaminy SD,1076,Sandburg MS,400,0,0,0,0.00%
Bucks,122097604,New Hope-Solebury SD,1084,New Hope-Solebury HS,487,1,0,1,0.21%
Bucks,122097604,New Hope-Solebury SD,7561,New Hope-Solebury MS,226,0,0,0,0.00%
Bucks,122097604,New Hope-Solebury SD,9999,New Hope-Solebury SD,1,0,0,0,0.00%
Bucks,122098003,Palisades SD,1094,Palisades HS,551,4,2,6,1.09%
Bucks,122098003,Palisades SD,7312,Palisades MS,212,0,0,0,0.00%
Bucks,122098003,Palisades SD,9999,Palisades SD,5,0,0,0,0.00%
Bucks,122098103,Pennridge SD,4681,Pennridge Central MS,411,0,0,0,0.00%
Bucks,122098103,Pennridge SD,1100,Pennridge HS,"2,338",1,1,2,0.09%
Bucks,122098103,Pennridge SD,7957,Pennridge North MS,411,1,0,1,0.24%
Bucks,122098103,Pennridge SD,9999,Pennridge SD,37,1,0,1,2.70%
Bucks,122098103,Pennridge SD,1099,Pennridge South MS,312,0,0,0,0.00%
Bucks,122098202,Pennsbury SD,7308,Charles H Boehm MS,477,0,0,0,0.00%
Bucks,122098202,Pennsbury SD,4682,Pennsbury HS,"2,940",6,3,9,0.31%
Bucks,122098202,Pennsbury SD,1116,Pennwood MS,530,0,0,0,0.00%
Bucks,122098202,Pennsbury SD,8441,Village Park Academy,7,0,0,0,0.00%
Bucks,122098202,Pennsbury SD,1113,William Penn MS,638,0,0,0,0.00%
Bucks,122098403,Quakertown Community SD,1128,Quakertown Community HS,"1,703",6,3,9,0.53%
Bucks,122098403,Quakertown Community SD,9999,Quakertown Community SD,8,0,0,0,0.00%
Bucks,122098403,Quakertown Community SD,4965,Strayer MS,855,0,0,0,0.00%
Bucks,122093140,School Lane CS,7568,School Lane CS,488,0,1,1,0.20%
Butler,104101252,Butler Area SD,6690,Butler Area IHS,"1,521",0,1,1,0.07%
Butler,104101252,Butler Area SD,9999,Butler Area SD,101,7,8,15,14.85%
Butler,104101252,Butler Area SD,8344,Butler Area SHS,"1,444",24,15,39,2.70%
Butler,104103603,Karns City Area SD,9999,Karns City Area SD,22,1,0,1,4.55%
Butler,104103603,Karns City Area SD,1154,Karns City HS,619,0,1,1,0.16%
Butler,104105003,Mars Area SD,5363,Mars Area MS,536,0,0,0,0.00%
Butler,104105003,Mars Area SD,1159,Mars Area SHS,"1,038",3,2,5,0.48%
Butler,104105353,Moniteau SD,1164,Moniteau JSHS,565,2,2,4,0.71%
Butler,104105353,Moniteau SD,9999,Moniteau SD,15,0,0,0,0.00%
Butler,104107903,Seneca Valley SD,5311,Ryan Gloyer MS,"1,120",0,0,0,0.00%
Butler,104107903,Seneca Valley SD,8318,Seneca Valley HS,"2,343",2,4,6,0.26%
Butler,104107903,Seneca Valley SD,9999,Seneca Valley SD,18,0,1,1,5.56%
Butler,104107503,Slippery Rock Area SD,1172,Slippery Rock Area HS,637,2,4,6,0.94%
Butler,104107503,Slippery Rock Area SD,6647,Slippery Rock Area MS,308,0,0,0,0.00%
Butler,104107503,Slippery Rock Area SD,9999,Slippery Rock Area SD,2,0,0,0,0.00%
Butler,104107803,South Butler County SD,1177,Knoch HS,772,5,1,6,0.78%
Butler,104107803,South Butler County SD,7460,Knoch MS,353,0,0,0,0.00%
Butler,104107803,South Butler County SD,9999,South Butler County SD,9,0,0,0,0.00%
Cambria,108110603,Blacklick Valley SD,5135,Blacklick Valley JSHS,325,3,3,6,1.85%
Cambria,108110603,Blacklick Valley SD,9999,Blacklick Valley SD,1,0,0,0,0.00%
Cambria,108111203,Cambria Heights SD,1199,Cambria Heights MS,225,0,0,0,0.00%
Cambria,108111203,Cambria Heights SD,9999,Cambria Heights SD,1,0,0,0,0.00%
Cambria,108111203,Cambria Heights SD,5212,Cambria Heights SHS,439,2,1,3,0.68%
Cambria,108111303,Central Cambria SD,1208,Central Cambria HS,532,0,1,1,0.19%
Cambria,108111303,Central Cambria SD,1202,Central Cambria MS,255,0,0,0,0.00%
Cambria,108111403,Conemaugh Valley SD,5136,Conemaugh Valley JSHS,303,1,1,2,0.66%
Cambria,108112003,Ferndale Area SD,1225,Ferndale Area JSHS,262,1,2,3,1.15%
Cambria,108112003,Ferndale Area SD,9999,Ferndale Area SD,3,0,0,0,0.00%
Cambria,108112203,Forest Hills SD,8382,Forest Hills JSHS,827,2,1,3,0.36%
Cambria,108112502,Greater Johnstown SD,1252,Greater Johnstown MS,219,1,3,4,1.83%
Cambria,108112502,Greater Johnstown SD,8314,Greater Johnstown School District's Cybe,39,3,1,4,10.26%
Cambria,108112502,Greater Johnstown SD,9999,Greater Johnstown SD,26,2,0,2,7.69%
Cambria,108112502,Greater Johnstown SD,1251,Greater Johnstown SHS,937,13,13,26,2.77%
Cambria,108114503,Northern Cambria SD,6201,Northern Cambria HS,366,5,0,5,1.37%
Cambria,108114503,Northern Cambria SD,6860,Northern Cambria MS,163,0,0,0,0.00%
Cambria,108116003,Penn Cambria SD,1213,Penn Cambria HS,559,0,0,0,0.00%
Cambria,108116003,Penn Cambria SD,6990,Penn Cambria MS,260,0,0,0,0.00%
Cambria,108116003,Penn Cambria SD,9999,Penn Cambria SD,7,0,0,0,0.00%
Cambria,108116303,Portage Area SD,1270,Portage Area JSHS,409,1,1,2,0.49%
Cambria,108116303,Portage Area SD,9999,Portage Area SD,1,0,0,0,0.00%
Cambria,108116503,Richland SD,7941,Richland HS,732,0,0,0,0.00%
Cambria,108116503,Richland SD,9999,Richland SD,4,0,0,0,0.00%
Cambria,108118503,Westmont Hilltop SD,8379,Westmont Hilltop JSHS,748,0,0,0,0.00%
Cameron,109122703,Cameron County SD,1299,Cameron County JSHS,226,1,0,1,0.44%
Carbon,121131507,Carbon Career & Technical Institute,4870,Carbon Career & Technical Institute,418,0,0,0,0.00%
Carbon,121135003,Jim Thorpe Area SD,1307,Jim Thorpe Area HS,597,4,0,4,0.67%
Carbon,121135003,Jim Thorpe Area SD,9999,Jim Thorpe Area SD,52,1,0,1,1.92%
Carbon,121135003,Jim Thorpe Area SD,6965,L B Morris El Sch,188,0,0,0,0.00%
Carbon,121135003,Jim Thorpe Area SD,7785,Penn-Kidder Campus,157,0,0,0,0.00%
Carbon,121135503,Lehighton Area SD,1315,Lehighton Area HS,743,4,1,5,0.67%
Carbon,121135503,Lehighton Area SD,1314,Lehighton Area MS,369,0,0,0,0.00%
Carbon,121136503,Palmerton Area SD,4734,Palmerton Area HS,469,1,1,2,0.43%
Carbon,121136503,Palmerton Area SD,7140,Palmerton Area JHS,301,0,0,0,0.00%
Carbon,121136503,Palmerton Area SD,9999,Palmerton Area SD,14,1,0,1,7.14%
Carbon,121136603,Panther Valley SD,8348,Panther Valley JSHS,692,14,3,17,2.46%
Carbon,121139004,Weatherly Area SD,6838,Weatherly Area MS,109,0,0,0,0.00%
Carbon,121139004,Weatherly Area SD,9999,Weatherly Area SD,6,0,0,0,0.00%
Carbon,121139004,Weatherly Area SD,1327,Weatherly Area SHS,179,2,0,2,1.12%
Centre,110141003,Bald Eagle Area SD,1335,Bald Eagle Area JSHS,752,3,0,3,0.40%
Centre,110141003,Bald Eagle Area SD,9999,Bald Eagle Area SD,2,0,0,0,0.00%
Centre,110141103,Bellefonte Area SD,1343,Bellefonte Area HS,882,5,2,7,0.79%
Centre,110141103,Bellefonte Area SD,1342,Bellefonte Area MS,437,0,0,0,0.00%
Centre,110143060,Centre Learning Community CS,7552,Centre Learning Community CS,49,0,0,0,0.00%
Centre,110147003,Penns Valley Area SD,6231,Penns Valley Area JSHS,657,0,2,2,0.30%
Centre,110148002,State College Area SD,7426,Mount Nittany MS,528,0,0,0,0.00%
Centre,110148002,State College Area SD,6234,Park Forest MS,534,0,0,0,0.00%
Centre,110148002,State College Area SD,1364,State College Area HS,"2,356",9,8,17,0.72%
Centre,110140001,Young Scholars of Central PA CS,7841,Young Scholars of Central PA CS,52,0,0,0,0.00%
Chester,124150002,21st Century Cyber CS,7691,21st Century Cyber CS,"1,209",48,57,105,8.68%
Chester,125230001,Achievement House CS,7824,Achievement House CS,588,49,43,92,15.65%
Chester,124150003,Avon Grove CS,9999,Avon Grove CS,2,0,0,0,0.00%
Chester,124150003,Avon Grove CS,7721,Avon Grove CS,656,0,0,0,0.00%
Chester,124150503,Avon Grove SD,1367,Avon Grove HS,"1,713",12,2,14,0.82%
Chester,124150503,Avon Grove SD,9999,Avon Grove SD,31,1,0,1,3.23%
Chester,124150503,Avon Grove SD,5216,Fred S Engle MS,857,0,0,0,0.00%
Chester,124151902,Coatesville Area SD,9999,Coatesville Area SD,9,1,0,1,11.11%
Chester,124151902,Coatesville Area SD,8415,Coatesville Area SD Cyber Academy,95,9,14,23,24.21%
Chester,124151902,Coatesville Area SD,5012,Coatesville Area SHS,880,7,6,13,1.48%
Chester,124151902,Coatesville Area SD,8416,Coatesville Intermediate HS,908,3,1,4,0.44%
Chester,124151902,Coatesville Area SD,8467,North Brandywine MS,774,0,0,0,0.00%
Chester,124153320,Collegium CS,9999,Collegium CS,1,0,0,0,0.00%
Chester,124153320,Collegium CS,7628,Collegium CS,"1,026",1,0,1,0.10%
Chester,124152003,Downingtown Area SD,7759,Downingtown HS East Campus,"1,720",4,0,4,0.23%
Chester,124152003,Downingtown Area SD,1387,Downingtown HS West Campus,"1,736",9,1,10,0.58%
Chester,124152003,Downingtown Area SD,7517,Downingtown MS,"1,126",0,0,0,0.00%
Chester,124152003,Downingtown Area SD,8174,Downingtown STEM Academy,825,0,0,0,0.00%
Chester,124152003,Downingtown Area SD,7516,Lionville MS,"1,107",0,0,0,0.00%
Chester,124153503,Great Valley SD,1424,Great Valley HS,"1,337",3,1,4,0.30%
Chester,124153503,Great Valley SD,1422,Great Valley MS,713,0,0,0,0.00%
Chester,124152637,Insight PA Cyber CS,8394,Insight PA Cyber CS,"1,123",103,111,214,19.06%
Chester,124154003,Kennett Consolidated SD,6482,Kennett HS,"1,362",6,5,11,0.81%
Chester,124154003,Kennett Consolidated SD,6834,Kennett MS,682,2,1,3,0.44%
Chester,124156503,Octorara Area SD,1414,Octorara Area JSHS,"1,101",7,2,9,0.82%
Chester,124156503,Octorara Area SD,9999,Octorara Area SD,4,1,0,1,25.00%
Chester,124156603,Owen J Roberts SD,1406,Owen J Roberts HS,"1,656",5,5,10,0.60%
Chester,124156603,Owen J Roberts SD,5010,Owen J Roberts MS,936,0,0,0,0.00%
Chester,124156603,Owen J Roberts SD,9999,Owen J Roberts SD,1,1,0,1,100.00%
Chester,124156703,Oxford Area SD,1420,Oxford Area HS,"1,292",4,6,10,0.77%
Chester,124156703,Oxford Area SD,1418,Penn's Grove Sch,577,1,0,1,0.17%
Chester,124150004,Pennsylvania Leadership CS,7819,Pennsylvania Leadership CS,"2,139",18,19,37,1.73%
Chester,124157203,Phoenixville Area SD,1426,Phoenixville Area HS,"1,189",7,7,14,1.18%
Chester,124157203,Phoenixville Area SD,1425,Phoenixville Area MS,643,0,0,0,0.00%
Chester,124157203,Phoenixville Area SD,9999,Phoenixville Area SD,2,0,0,0,0.00%
Chester,124153350,Renaissance Academy CS,7636,Renaissance Academy CS,477,0,0,0,0.00%
Chester,124157802,Tredyffrin-Easttown SD,1423,Conestoga SHS,"2,243",0,0,0,0.00%
Chester,124157802,Tredyffrin-Easttown SD,1421,Tredyffrin-Easttown MS,607,0,0,0,0.00%
Chester,124157802,Tredyffrin-Easttown SD,9999,Tredyffrin-Easttown SD,8,0,0,0,0.00%
Chester,124157802,Tredyffrin-Easttown SD,4689,Valley Forge MS,641,0,0,0,0.00%
Chester,124158503,Unionville-Chadds Ford SD,6719,Charles F Patton MS,651,0,0,0,0.00%
Chester,124158503,Unionville-Chadds Ford SD,1443,Unionville HS,"1,324",0,0,0,0.00%
Chester,124159002,West Chester Area SD,1452,E N Peirce MS,711,0,0,0,0.00%
Chester,124159002,West Chester Area SD,5137,J R Fugett MS,573,0,0,0,0.00%
Chester,124159002,West Chester Area SD,1451,Stetson MS,566,0,0,0,0.00%
Chester,124159002,West Chester Area SD,9999,West Chester Area SD,1,0,0,0,0.00%
Chester,124159002,West Chester Area SD,7894,West Chester Bayard Rustin HS,"1,296",1,1,2,0.15%
Chester,124159002,West Chester Area SD,6734,West Chester East HS,"1,234",2,0,2,0.16%
Chester,124159002,West Chester Area SD,1453,West Chester Henderson HS,"1,333",3,0,3,0.23%
Clarion,106160303,Allegheny-Clarion Valley SD,7467,Allegheny-Clarion Valley Elem,1,0,0,0,0.00%
Clarion,106160303,Allegheny-Clarion Valley SD,4664,Allegheny-Clarion Valley HS,274,3,1,4,1.46%
Clarion,106160303,Allegheny-Clarion Valley SD,9999,Allegheny-Clarion Valley SD,29,0,0,0,0.00%
Clarion,106161203,Clarion Area SD,1475,Clarion Area JSHS,335,2,0,2,0.60%
Clarion,106161203,Clarion Area SD,9999,Clarion Area SD,6,0,0,0,0.00%
Clarion,106161703,Clarion-Limestone Area SD,1480,Clarion-Limestone Area JSHS,385,1,0,1,0.26%
Clarion,106166503,Keystone SD,1486,Keystone JSHS,479,1,3,4,0.84%
Clarion,106167504,North Clarion County SD,1489,North Clarion Co JSHS,295,0,0,0,0.00%
Clarion,106167504,North Clarion County SD,9999,North Clarion County SD,1,0,0,0,0.00%
Clarion,106168003,Redbank Valley SD,1495,Redbank Valley HS,480,3,0,3,0.63%
Clarion,106169003,Union SD,1501,Union HS,264,2,1,3,1.14%
Clarion,106169003,Union SD,9999,Union SD,9,0,0,0,0.00%
Clearfield,110171003,Clearfield Area SD,6236,Clearfield Area JSHS,"1,026",8,7,15,1.46%
Clearfield,110171003,Clearfield Area SD,9999,Clearfield Area SD,11,0,0,0,0.00%
Clearfield,110171803,Curwensville Area SD,1529,Curwensville Area JSHS,489,3,1,4,0.82%
Clearfield,106172003,Dubois Area SD,1541,Dubois Area MS,573,0,0,0,0.00%
Clearfield,106172003,Dubois Area SD,9999,Dubois Area SD,19,2,0,2,10.53%
Clearfield,106172003,Dubois Area SD,6156,Dubois Area SHS,"1,028",10,3,13,1.26%
Clearfield,110173003,Glendale SD,5219,Glendale JSHS,351,3,0,3,0.85%
Clearfield,110173003,Glendale SD,9999,Glendale SD,6,1,0,1,16.67%
Clearfield,110173504,Harmony Area SD,8316,Harmony Area JSHS,120,0,0,0,0.00%
Clearfield,110173504,Harmony Area SD,9999,Harmony Area SD,1,0,0,0,0.00%
Clearfield,110175003,Moshannon Valley SD,1550,Moshannon Valley JSHS,403,2,0,2,0.50%
Clearfield,110175003,Moshannon Valley SD,9999,Moshannon Valley SD,5,0,0,0,0.00%
Clearfield,110177003,Philipsburg-Osceola Area SD,1560,Philipsburg-Osceola Area HS,480,5,3,8,1.67%
Clearfield,110177003,Philipsburg-Osceola Area SD,8301,Philipsburg-Osceola Area MS,259,0,0,0,0.00%
Clearfield,110177003,Philipsburg-Osceola Area SD,9999,Philipsburg-Osceola Area SD,3,0,0,0,0.00%
Clearfield,110179003,West Branch Area SD,1566,West Branch Area HS,295,3,3,6,2.03%
Clearfield,110179003,West Branch Area SD,8456,West Branch MS,170,0,0,0,0.00%
Clinton,110183602,Keystone Central SD,7795,Bucktail Area MS,60,0,0,0,0.00%
Clinton,110183602,Keystone Central SD,6241,Bucktail HS,122,1,2,3,2.46%
Clinton,110183602,Keystone Central SD,7589,Central Mountain HS,"1,081",8,9,17,1.57%
Clinton,110183602,Keystone Central SD,7590,Central Mountain MS,561,0,0,0,0.00%
Clinton,110183602,Keystone Central SD,9999,Keystone Central SD,5,0,0,0,0.00%
Clinton,101833400,Sugar Valley Rural CS,7635,Sugar Valley Rural CS,237,1,2,3,1.27%
Columbia,116191004,Benton Area SD,8434,Benton Area HS,181,0,0,0,0.00%
Columbia,116191004,Benton Area SD,8433,Benton Area MS,111,0,0,0,0.00%
Columbia,116191004,Benton Area SD,9999,Benton Area SD,2,0,0,0,0.00%
Columbia,116191103,Berwick Area SD,1605,Berwick Area HS,762,14,7,21,2.76%
Columbia,116191103,Berwick Area SD,6808,Berwick Area MS,499,0,0,0,0.00%
Columbia,116191203,Bloomsburg Area SD,1612,Bloomsburg Area HS,418,5,1,6,1.44%
Columbia,116191203,Bloomsburg Area SD,1611,Bloomsburg Area MS,252,0,0,0,0.00%
Columbia,116191203,Bloomsburg Area SD,9999,Bloomsburg Area SD,1,0,0,0,0.00%
Columbia,116191503,Central Columbia SD,5390,Central Columbia MS,327,0,0,0,0.00%
Columbia,116191503,Central Columbia SD,9999,Central Columbia SD,5,0,0,0,0.00%
Columbia,116191503,Central Columbia SD,1619,Central Columbia SHS,569,0,2,2,0.35%
Columbia,116191757,Columbia-Montour AVTS,5178,Columbia-Montour AVTS,644,4,1,5,0.78%
Columbia,116195004,Millville Area SD,1623,Millville Area JSHS,296,3,1,4,1.35%
Columbia,116195004,Millville Area SD,9999,Millville Area SD,2,0,0,0,0.00%
Columbia,116197503,Southern Columbia Area SD,9999,Southern Columbia Area SD,1,0,0,0,0.00%
Columbia,116197503,Southern Columbia Area SD,1627,Southern Columbia HS,391,3,1,4,1.02%
Columbia,116197503,Southern Columbia Area SD,7668,Southern Columbia MS,226,0,0,0,0.00%
Columbia,116493130,Susq-Cyber CS,7567,Susq-Cyber CS,76,4,9,13,17.11%
Crawford,105201033,Conneaut SD,8224,Conneaut Area Senior High,614,3,4,7,1.14%
Crawford,105201033,Conneaut SD,8225,Conneaut Lake MS,162,0,0,0,0.00%
Crawford,105201033,Conneaut SD,9999,Conneaut SD,1,0,0,0,0.00%
Crawford,105201033,Conneaut SD,8226,Conneaut Valley MS,135,0,0,0,0.00%
Crawford,105201352,Crawford Central SD,1632,Cochranton JSHS,382,0,0,0,0.00%
Crawford,105201352,Crawford Central SD,1654,Meadville Area SHS,821,15,3,18,2.19%
Crawford,105201352,Crawford Central SD,1653,Meadville MS,458,0,0,0,0.00%
Crawford,105204703,Penncrest SD,1629,Cambridge Springs JSHS,410,2,0,2,0.49%
Crawford,105204703,Penncrest SD,6942,Maplewood JSHS,464,0,3,3,0.65%
Crawford,105204703,Penncrest SD,9999,Penncrest SD,2,0,0,0,0.00%
Crawford,105204703,Penncrest SD,6136,Saegertown JSHS,446,3,1,4,0.90%
Cumberland,115210503,Big Spring SD,1677,Big Spring HS,794,7,1,8,1.01%
Cumberland,115210503,Big Spring SD,6326,Big Spring MS,398,0,0,0,0.00%
Cumberland,115211003,Camp Hill SD,7509,Camp Hill MS,237,0,0,0,0.00%
Cumberland,115211003,Camp Hill SD,9999,Camp Hill SD,3,0,0,0,0.00%
Cumberland,115211003,Camp Hill SD,1682,Camp Hill SHS,417,0,1,1,0.24%
Cumberland,115211103,Carlisle Area SD,1694,Carlisle Area HS,"1,573",19,15,34,2.16%
Cumberland,115211103,Carlisle Area SD,9999,Carlisle Area SD,24,1,1,2,8.33%
Cumberland,115211103,Carlisle Area SD,7011,Lamberton MS,381,0,0,0,0.00%
Cumberland,115211103,Carlisle Area SD,7010,Wilson MS,407,0,0,0,0.00%
Cumberland,115211603,Cumberland Valley SD,1701,Cumberland Valley HS,"2,809",9,8,17,0.61%
Cumberland,115211603,Cumberland Valley SD,9999,Cumberland Valley SD,15,2,0,2,13.33%
Cumberland,115211603,Cumberland Valley SD,6714,Eagle View MS,639,0,0,0,0.00%
Cumberland,115211603,Cumberland Valley SD,4849,Mountain View MS,860,0,0,0,0.00%
Cumberland,115212503,East Pennsboro Area SD,5220,East Pennsboro Area MS,393,0,1,1,0.25%
Cumberland,115212503,East Pennsboro Area SD,9999,East Pennsboro Area SD,20,2,0,2,10.00%
Cumberland,115212503,East Pennsboro Area SD,1707,East Pennsboro Area SHS,780,4,7,11,1.41%
Cumberland,115216503,Mechanicsburg Area SD,9999,Mechanicsburg Area SD,14,0,0,0,0.00%
Cumberland,115216503,Mechanicsburg Area SD,5098,Mechanicsburg Area SHS,"1,220",8,4,12,0.98%
Cumberland,115216503,Mechanicsburg Area SD,1715,Mechanicsburg MS,663,0,0,0,0.00%
Cumberland,115218003,Shippensburg Area SD,1729,Shippensburg Area MS,552,0,0,0,0.00%
Cumberland,115218003,Shippensburg Area SD,5221,Shippensburg Area SHS,"1,059",11,4,15,1.42%
Cumberland,115218303,South Middleton SD,6328,Boiling Springs HS,646,6,5,11,1.70%
Cumberland,115218303,South Middleton SD,9999,South Middleton SD,5,0,0,0,0.00%
Cumberland,115218303,South Middleton SD,7611,Yellow Breeches MS,364,0,0,0,0.00%
Dauphin,115227010,Capital Area School for the Arts CS,8278,Capital Area School for the Arts Charter,200,0,1,1,0.50%
Dauphin,115221402,Central Dauphin SD,1744,Central Dauphin East MS,531,0,3,3,0.56%
Dauphin,115221402,Central Dauphin SD,1746,Central Dauphin East SHS,"1,520",23,14,37,2.43%
Dauphin,115221402,Central Dauphin SD,7820,Central Dauphin MS,529,0,1,1,0.19%
Dauphin,115221402,Central Dauphin SD,9999,Central Dauphin SD,74,14,0,14,18.92%
Dauphin,115221402,Central Dauphin SD,1745,Central Dauphin SHS,"1,815",9,5,14,0.77%
Dauphin,115221402,Central Dauphin SD,6783,Linglestown MS,524,0,0,0,0.00%
Dauphin,115221402,Central Dauphin SD,1742,Swatara MS,364,0,0,0,0.00%
Dauphin,115220002,Commonwealth Charter Academy CS,7774,Commonwealth Charter Academy CS,"6,511",229,232,461,7.08%
Dauphin,115221607,Dauphin County Technical School,5278,Dauphin County Technical School,"1,012",3,0,3,0.30%
Dauphin,115221753,Derry Township SD,9999,Derry Township SD,9,0,0,0,0.00%
Dauphin,115221753,Derry Township SD,4801,Hershey HS,"1,225",1,0,1,0.08%
Dauphin,115221753,Derry Township SD,6678,Hershey MS,560,0,0,0,0.00%
Dauphin,115222504,Halifax Area SD,6330,Halifax Area HS,256,3,2,5,1.95%
Dauphin,115222504,Halifax Area SD,6331,Halifax Area MS,158,0,0,0,0.00%
Dauphin,115222504,Halifax Area SD,9999,Halifax Area SD,5,0,0,0,0.00%
Dauphin,115222752,Harrisburg City SD,8264,Camp Curtin Academy,338,0,1,1,0.30%
Dauphin,115222752,Harrisburg City SD,8376,Cougar Academy,121,0,2,2,1.65%
Dauphin,115222752,Harrisburg City SD,9999,Harrisburg City SD,110,6,0,6,5.45%
Dauphin,115222752,Harrisburg City SD,6333,Harrisburg HS,992,38,30,68,6.85%
Dauphin,115222752,Harrisburg City SD,7902,Harrisburg HS - SciTech Cmp,363,0,0,0,0.00%
Dauphin,115222752,Harrisburg City SD,8266,Marshall Academy,68,0,0,0,0.00%
Dauphin,115222752,Harrisburg City SD,7901,Marshall Math Science Academy,152,0,0,0,0.00%
Dauphin,115222752,Harrisburg City SD,7623,Rowland Academy,370,4,2,6,1.62%
Dauphin,115220001,Infinity CS,7765,Infinity CS,54,0,0,0,0.00%
Dauphin,115224003,Lower Dauphin SD,1776,Lower Dauphin HS,"1,131",7,1,8,0.71%
Dauphin,115224003,Lower Dauphin SD,7414,Lower Dauphin MS,623,0,0,0,0.00%
Dauphin,115224003,Lower Dauphin SD,9999,Lower Dauphin SD,6,1,0,1,16.67%
Dauphin,115224003,Lower Dauphin SD,7844,Price,10,0,1,1,10.00%
Dauphin,115226003,Middletown Area SD,1790,Middletown Area HS,676,7,5,12,1.78%
Dauphin,115226003,Middletown Area SD,1785,Middletown Area MS,417,0,0,0,0.00%
Dauphin,115226003,Middletown Area SD,9999,Middletown Area SD,2,0,0,0,0.00%
Dauphin,115226103,Millersburg Area SD,6682,Millersburg Area MS,125,0,0,0,0.00%
Dauphin,115226103,Millersburg Area SD,1794,Millersburg Area SHS,227,3,4,7,3.08%
Dauphin,115227871,Reach Cyber CS,8366,Reach Cyber CS,"2,229",55,44,99,4.44%
Dauphin,115228003,Steelton-Highspire SD,1801,Steelton-Highspire HS,540,9,11,20,3.70%
Dauphin,115228303,Susquehanna Township SD,9999,Susquehanna Township SD,33,0,0,0,0.00%
Dauphin,115228303,Susquehanna Township SD,1806,Susquehanna Twp HS,719,3,1,4,0.56%
Dauphin,115228303,Susquehanna Township SD,1805,Susquehanna Twp MS,466,0,0,0,0.00%
Dauphin,115229003,Upper Dauphin Area SD,6340,Upper Dauphin Area HS,364,3,3,6,1.65%
Dauphin,115229003,Upper Dauphin Area SD,6339,Upper Dauphin Area MS,185,0,0,0,0.00%
Delaware,125236827,Chester Charter Scholars Academy CS,8258,Chester Charter Scholars Academy CS,311,1,1,2,0.64%
Delaware,125232950,Chester Community CS,7539,Chester Community CS,682,8,14,22,3.23%
Delaware,125231232,Chester-Upland SD,6492,Chester HS,900,30,34,64,7.11%
Delaware,125231232,Chester-Upland SD,8303,STEM at Showalter,432,0,1,1,0.23%
Delaware,125231232,Chester-Upland SD,8302,Toby Farms Intermediate School,254,0,1,1,0.39%
Delaware,125231303,Chichester SD,7276,Chichester MS,502,0,0,0,0.00%
Delaware,125231303,Chichester SD,1849,Chichester SHS,926,13,4,17,1.84%
Delaware,125234103,Garnet Valley SD,1869,Garnet Valley HS,"1,569",1,1,2,0.13%
Delaware,125234103,Garnet Valley SD,7313,Garnet Valley MS,789,0,1,1,0.13%
Delaware,125234502,Haverford Township SD,1878,Haverford MS,"1,029",0,0,0,0.00%
Delaware,125234502,Haverford Township SD,1879,Haverford SHS,"1,886",5,3,8,0.42%
Delaware,125234502,Haverford Township SD,9999,Haverford Township SD,4,0,0,0,0.00%
Delaware,125235103,Interboro SD,1881,Glenolden Sch,155,0,0,0,0.00%
Delaware,125235103,Interboro SD,1885,Interboro SHS,"1,057",6,2,8,0.76%
Delaware,125235103,Interboro SD,1883,Norwood Sch,131,0,0,0,0.00%
Delaware,125235103,Interboro SD,6508,Prospect Park Sch,140,0,0,0,0.00%
Delaware,125235103,Interboro SD,4847,Tinicum Sch,86,0,0,0,0.00%
Delaware,125235502,Marple Newtown SD,9999,Marple Newtown SD,26,0,0,0,0.00%
Delaware,125235502,Marple Newtown SD,1902,Marple Newtown SHS,"1,054",1,1,2,0.19%
Delaware,125235502,Marple Newtown SD,1901,Paxon Hollow MS,534,0,0,0,0.00%
Delaware,125236903,Penn-Delco SD,5143,Northley MS,557,0,0,0,0.00%
Delaware,125236903,Penn-Delco SD,9999,Penn-Delco SD,4,0,0,0,0.00%
Delaware,125236903,Penn-Delco SD,1915,Sun Valley HS,"1,050",0,1,1,0.10%
Delaware,125237603,Radnor Township SD,6511,Radnor MS,596,0,0,0,0.00%
Delaware,125237603,Radnor Township SD,1921,Radnor SHS,"1,196",0,0,0,0.00%
Delaware,125237702,Ridley SD,1934,Ridley HS,"1,822",2,3,5,0.27%
Delaware,125237702,Ridley SD,7218,Ridley MS,864,0,0,0,0.00%
Delaware,125237702,Ridley SD,9999,Ridley SD,3,0,0,0,0.00%
Delaware,125237903,Rose Tree Media SD,1942,Penncrest HS,"1,194",0,1,1,0.08%
Delaware,125237903,Rose Tree Media SD,9999,Rose Tree Media SD,8,0,0,0,0.00%
Delaware,125237903,Rose Tree Media SD,6625,Springton Lake MS,624,0,0,0,0.00%
Delaware,125238402,Southeast Delco SD,6516,Academy Park HS,"1,303",22,7,29,2.23%
Delaware,125238402,Southeast Delco SD,1861,Darby Twp Sch,162,0,0,0,0.00%
Delaware,125238402,Southeast Delco SD,6505,Delcroft Sch,180,0,0,0,0.00%
Delaware,125238402,Southeast Delco SD,6501,Harris Sch,205,0,0,0,0.00%
Delaware,125238402,Southeast Delco SD,1943,Sharon Hill Sch,159,1,0,1,0.63%
Delaware,125238502,Springfield SD,1949,Richardson MS,644,0,0,0,0.00%
Delaware,125238502,Springfield SD,1950,Springfield HS,"1,320",0,1,1,0.08%
Delaware,125239452,Upper Darby SD,1970,Beverly Hills MS,"1,015",0,0,0,0.00%
Delaware,125239452,Upper Darby SD,1971,Drexel Hill MS,973,0,0,0,0.00%
Delaware,125239452,Upper Darby SD,9999,Upper Darby SD,78,2,3,5,6.41%
Delaware,125239452,Upper Darby SD,1972,Upper Darby SHS,"3,845",37,27,64,1.66%
Delaware,125233517,Vision Academy CS,8338,Vision Academy Charter School,68,0,0,0,0.00%
Delaware,125239603,Wallingford-Swarthmore SD,5287,Strath Haven HS,"1,194",2,0,2,0.17%
Delaware,125239603,Wallingford-Swarthmore SD,1908,Strath Haven MS,604,0,0,0,0.00%
Delaware,125230002,Widener Partnership CS,7907,Widener Partnership CS,65,0,0,0,0.00%
Delaware,125239652,William Penn SD,8231,Penn Wood HS,"1,457",22,13,35,2.40%
Delaware,125239652,William Penn SD,7918,Penn Wood MS,730,0,0,0,0.00%
Elk,109243503,Johnsonburg Area SD,6218,Johnsonburg Area HS,277,1,3,4,1.44%
Elk,109243503,Johnsonburg Area SD,9999,Johnsonburg Area SD,2,0,0,0,0.00%
Elk,109246003,Ridgway Area SD,1989,Ridgway Area HS,237,4,2,6,2.53%
Elk,109246003,Ridgway Area SD,6805,Ridgway Area MS,113,0,0,0,0.00%
Elk,109248003,Saint Marys Area SD,9999,Saint Marys Area SD,2,0,0,0,0.00%
Elk,109248003,Saint Marys Area SD,1992,St Marys Area MS,341,0,0,0,0.00%
Elk,109248003,Saint Marys Area SD,5169,St Marys Area SHS,664,6,4,10,1.51%
Erie,105251453,Corry Area SD,1998,Corry Area HS,610,5,2,7,1.15%
Erie,105251453,Corry Area SD,7793,Corry Area MS,333,0,0,0,0.00%
Erie,105251453,Corry Area SD,9999,Corry Area SD,2,0,0,0,0.00%
Erie,105252602,Erie City SD,8419,East MS,450,0,0,0,0.00%
Erie,105252602,Erie City SD,9999,Erie City SD,37,6,1,7,18.92%
Erie,105252602,Erie City SD,8417,Erie HS,"2,149",120,93,213,9.91%
Erie,105252602,Erie City SD,7515,Northwest PA Collegiate Academy,860,2,1,3,0.35%
Erie,105252602,Erie City SD,8420,Strong Vincent MS,544,0,0,0,0.00%
Erie,105252602,Erie City SD,2025,Woodrow Wilson MS,500,0,0,0,0.00%
Erie,105257512,Erie Rise Leadership Academy CS,8163,Erie Rise Leadership Academy Charter Sch,79,0,0,0,0.00%
Erie,105253303,Fairview SD,6737,Fairview HS,546,0,1,1,0.18%
Erie,105253303,Fairview SD,2032,Fairview MS,288,0,0,0,0.00%
Erie,105253303,Fairview SD,9999,Fairview SD,1,0,0,0,0.00%
Erie,105253553,Fort LeBoeuf SD,5328,Fort LeBoeuf MS,359,0,0,0,0.00%
Erie,105253553,Fort LeBoeuf SD,9999,Fort LeBoeuf SD,4,0,0,0,0.00%
Erie,105253553,Fort LeBoeuf SD,2037,Fort LeBoeuf SHS,657,1,3,4,0.61%
Erie,105253903,General McLane SD,2040,General McLane HS,709,4,2,6,0.85%
Erie,105253903,General McLane SD,5225,James W Parker MS,329,0,0,0,0.00%
Erie,105254053,Girard SD,2043,Girard HS,491,8,5,13,2.65%
Erie,105254053,Girard SD,9999,Girard SD,4,0,0,0,0.00%
Erie,105254053,Girard SD,6777,Rice Avenue MS,255,0,0,0,0.00%
Erie,105254353,Harbor Creek SD,2048,Harbor Creek Junior HS,343,0,0,0,0.00%
Erie,105254353,Harbor Creek SD,7948,Harbor Creek Senior HS,690,0,1,1,0.14%
Erie,105256553,Iroquois SD,4817,Iroquois JSHS,582,6,3,9,1.55%
Erie,105257602,Millcreek Township SD,4954,James S Wilson MS,381,0,0,0,0.00%
Erie,105257602,Millcreek Township SD,8071,McDowell HS,"2,139",7,3,10,0.47%
Erie,105257602,Millcreek Township SD,9999,Millcreek Township SD,44,0,0,0,0.00%
Erie,105257602,Millcreek Township SD,7384,Walnut Creek MS,330,0,0,0,0.00%
Erie,105257602,Millcreek Township SD,2062,Westlake MS,406,0,0,0,0.00%
Erie,105258303,North East SD,6145,North East HS,491,5,2,7,1.43%
Erie,105258303,North East SD,7360,North East MS,290,0,0,0,0.00%
Erie,105258503,Northwestern SD,6146,Northwestern MS,252,0,0,0,0.00%
Erie,105258503,Northwestern SD,6745,Northwestern SHS,418,3,2,5,1.20%
Erie,105250001,Perseus House CS of Excellence,7770,Perseus House CS of Excellence,556,19,13,32,5.76%
Erie,105252920,Robert Benjamin Wiley Community CS,7532,Robert Benjamin Wiley Community CS,100,1,0,1,1.00%
Erie,105259103,Union City Area SD,9999,Union City Area SD,1,0,0,0,0.00%
Erie,105259103,Union City Area SD,2075,Union City HS,313,1,0,1,0.32%
Erie,105259103,Union City Area SD,7289,Union City MS,176,0,0,0,0.00%
Erie,105259703,Wattsburg Area SD,6148,Seneca HS,439,2,0,2,0.46%
Erie,105259703,Wattsburg Area SD,6654,Wattsburg Area MS,206,0,0,0,0.00%
Fayette,101260303,Albert Gallatin Area SD,6001,Albert Gallatin Area SHS,"1,041",12,11,23,2.21%
Fayette,101260303,Albert Gallatin Area SD,7607,Albert Gallatin North MS,251,0,0,0,0.00%
Fayette,101260303,Albert Gallatin Area SD,7608,Albert Gallatin South MS,248,2,0,2,0.81%
Fayette,101260803,Brownsville Area SD,4818,Brownsville Area HS,464,13,11,24,5.17%
Fayette,101260803,Brownsville Area SD,2154,Brownsville Area MS,231,1,1,2,0.87%
Fayette,101266007,Connellsville Area Career & Technical Ce,6643,Connellsville Area Career & Technical Ce,523,1,1,2,0.38%
Fayette,101261302,Connellsville Area SD,2105,Connellsville Area MS,714,0,0,0,0.00%
Fayette,101261302,Connellsville Area SD,5228,Connellsville Area SHS,"1,175",28,9,37,3.15%
Fayette,101262903,Frazier SD,2126,Frazier HS,340,2,0,2,0.59%
Fayette,101262903,Frazier SD,7176,Frazier MS,155,0,0,0,0.00%
Fayette,101262903,Frazier SD,9999,Frazier SD,7,0,0,0,0.00%
Fayette,101264003,Laurel Highlands SD,5146,Laurel Highlands MS,459,1,0,1,0.22%
Fayette,101264003,Laurel Highlands SD,9999,Laurel Highlands SD,45,2,1,3,6.67%
Fayette,101264003,Laurel Highlands SD,6600,Laurel Highlands SHS,867,3,8,11,1.27%
Fayette,101268003,Uniontown Area SD,6933,A J McMullen Sch,93,0,0,0,0.00%
Fayette,101268003,Uniontown Area SD,2182,Ben Franklin Sch,175,0,0,0,0.00%
Fayette,101268003,Uniontown Area SD,7934,Lafayette MS,123,0,0,0,0.00%
Fayette,101268003,Uniontown Area SD,9999,Uniontown Area SD,29,6,0,6,20.69%
Fayette,101268003,Uniontown Area SD,2184,Uniontown Area SHS,780,14,10,24,3.08%
Forest,106272003,Forest Area SD,6159,East Forest JSHS,79,0,0,0,0.00%
Forest,106272003,Forest Area SD,9999,Forest Area SD,16,0,0,0,0.00%
Forest,106272003,Forest Area SD,6161,West Forest JSHS,121,0,1,1,0.83%
Franklin,112281302,Chambersburg Area SD,8244,Chambersburg Area Career Magnet Sch,702,2,0,2,0.28%
Franklin,112281302,Chambersburg Area SD,2190,Chambersburg Area MS - North,798,0,0,0,0.00%
Franklin,112281302,Chambersburg Area SD,6615,Chambersburg Area MS - South,724,0,0,0,0.00%
Franklin,112281302,Chambersburg Area SD,9999,Chambersburg Area SD,42,1,1,2,4.76%
Franklin,112281302,Chambersburg Area SD,2191,Chambersburg Area SHS,"2,128",59,23,82,3.85%
Franklin,112282004,Fannett-Metal SD,7508,Fannett-Metal MS,87,0,0,0,0.00%
Franklin,112282004,Fannett-Metal SD,2201,Fannett-Metal SHS,139,0,1,1,0.72%
Franklin,112283003,Greencastle-Antrim SD,5117,Greencastle-Antrim MS,518,0,0,0,0.00%
Franklin,112283003,Greencastle-Antrim SD,2206,Greencastle-Antrim SHS,928,3,4,7,0.75%
Franklin,112286003,Tuscarora SD,6280,James Buchanan HS,695,8,9,17,2.45%
Franklin,112286003,Tuscarora SD,6281,James Buchanan MS,390,0,0,0,0.00%
Franklin,112286003,Tuscarora SD,9999,Tuscarora SD,1,0,0,0,0.00%
Franklin,112289003,Waynesboro Area SD,8408,Waynesboro Area MS,746,0,0,0,0.00%
Franklin,112289003,Waynesboro Area SD,2243,Waynesboro Area SHS,"1,279",12,7,19,1.49%
Fulton,111291304,Central Fulton SD,6252,McConnellsburg HS,268,3,0,3,1.12%
Fulton,111291304,Central Fulton SD,7734,McConnellsburg MS,165,0,0,0,0.00%
Fulton,111292304,Forbes Road SD,2246,Forbes Road JSHS,146,2,0,2,1.37%
Fulton,111297504,Southern Fulton SD,2253,Southern Fulton JSHS,330,3,2,5,1.52%
Greene,101301303,Carmichaels Area SD,7112,Carmichaels Area HS,352,0,1,1,0.28%
Greene,101301303,Carmichaels Area SD,8345,Carmichaels Area MS,147,0,0,0,0.00%
Greene,101301403,Central Greene SD,9999,Central Greene SD,7,0,0,0,0.00%
Greene,101301403,Central Greene SD,6010,Miller MS,259,0,0,0,0.00%
Greene,101301403,Central Greene SD,5118,Waynesburg Central HS,519,3,4,7,1.35%
Greene,101303503,Jefferson-Morgan SD,7029,Jefferson-Morgan El Sch,9,0,0,0,0.00%
Greene,101303503,Jefferson-Morgan SD,2280,Jefferson-Morgan MS/HS,312,2,1,3,0.96%
Greene,101306503,Southeastern Greene SD,2284,Mapletown JSHS,247,0,0,0,0.00%
Greene,101306503,Southeastern Greene SD,9999,Southeastern Greene SD,1,0,0,0,0.00%
Greene,101308503,West Greene SD,8442,West Greene JSHS,295,2,1,3,1.02%
Greene,101308503,West Greene SD,9999,West Greene SD,5,0,0,0,0.00%
Huntingdon,111312503,Huntingdon Area SD,5333,Huntingdon Area MS,292,0,0,0,0.00%
Huntingdon,111312503,Huntingdon Area SD,9999,Huntingdon Area SD,9,2,0,2,22.22%
Huntingdon,111312503,Huntingdon Area SD,2305,Huntingdon Area SHS,555,5,6,11,1.98%
Huntingdon,111312804,Juniata Valley SD,2308,Juniata Valley JSHS,363,2,0,2,0.55%
Huntingdon,111316003,Mount Union Area SD,2297,Mount Union Area JHS,207,0,0,0,0.00%
Huntingdon,111316003,Mount Union Area SD,7944,Mount Union Area SHS,399,0,1,1,0.25%
Huntingdon,111440001,New Day CS,7762,New Day Charter School,161,8,6,14,8.70%
Huntingdon,111317503,Southern Huntingdon County SD,2313,Southern Huntingdon Co HS/MS,529,0,1,1,0.19%
Indiana,128321103,Blairsville-Saltsburg SD,2317,Blairsville MS,141,0,0,0,0.00%
Indiana,128321103,Blairsville-Saltsburg SD,4706,Blairsville SHS,284,4,5,9,3.17%
Indiana,128321103,Blairsville-Saltsburg SD,9999,Blairsville-Saltsburg SD,10,0,0,0,0.00%
Indiana,128321103,Blairsville-Saltsburg SD,2353,Saltsburg MS/HS,240,0,1,1,0.42%
Indiana,128323303,Homer-Center SD,2331,Homer-Center JSHS,418,0,2,2,0.48%
Indiana,128323703,Indiana Area SD,2324,Indiana Area JHS,455,1,0,1,0.22%
Indiana,128323703,Indiana Area SD,9999,Indiana Area SD,11,0,0,0,0.00%
Indiana,128323703,Indiana Area SD,2325,Indiana Area SHS,903,3,6,9,1.00%
Indiana,128325203,Marion Center Area SD,2339,Marion Center Area JR/SR HS,600,2,2,4,0.67%
Indiana,128326303,Penns Manor Area SD,2345,Penns Manor Area JSHS,367,1,1,2,0.54%
Indiana,128326303,Penns Manor Area SD,9999,Penns Manor Area SD,15,0,0,0,0.00%
Indiana,128327303,Purchase Line SD,2350,Purchase Line JSHS,380,1,0,1,0.26%
Indiana,128327303,Purchase Line SD,9999,Purchase Line SD,6,0,0,0,0.00%
Indiana,128328003,United SD,2358,United JSHS,478,0,0,0,0.00%
Indiana,128328003,United SD,9999,United SD,8,1,0,1,12.50%
Jefferson,106330703,Brockway Area SD,2362,Brockway Area JSHS,448,1,0,1,0.22%
Jefferson,106330703,Brockway Area SD,9999,Brockway Area SD,2,0,0,0,0.00%
Jefferson,106330803,Brookville Area SD,6162,Brookville JSHS,667,4,2,6,0.90%
Jefferson,106333407,Jefferson County-DuBois AVTS,5180,Jefferson County-DuBois AVTS,374,3,2,5,1.34%
Jefferson,106338003,Punxsutawney Area SD,8437,Punxsutawney Area El Sch,1,0,0,0,0.00%
Jefferson,106338003,Punxsutawney Area SD,6165,Punxsutawney Area HS,864,8,5,13,1.50%
Jefferson,106338003,Punxsutawney Area SD,9999,Punxsutawney Area SD,19,0,0,0,0.00%
Juniata,111343603,Juniata County SD,2394,East Juniata JSHS,489,1,1,2,0.41%
Juniata,111343603,Juniata County SD,6255,Juniata SHS,588,7,4,11,1.87%
Juniata,111343603,Juniata County SD,7220,Tuscarora MS,272,0,3,3,1.10%
Lackawanna,119350303,Abington Heights SD,5091,Abington Heights HS,"1,075",5,2,7,0.65%
Lackawanna,119350303,Abington Heights SD,6839,Abington Heights MS,549,0,0,0,0.00%
Lackawanna,119350303,Abington Heights SD,9999,Abington Heights SD,9,0,0,0,0.00%
Lackawanna,119351303,Carbondale Area SD,2420,Carbondale Area JSHS,721,4,3,7,0.97%
Lackawanna,119351303,Carbondale Area SD,9999,Carbondale Area SD,7,0,0,0,0.00%
Lackawanna,119352203,Dunmore SD,8312,Dunmore JSHS,703,2,1,3,0.43%
Lackawanna,119350001,Fell CS,7746,Fell CS,21,0,0,0,0.00%
Lackawanna,119355028,Howard Gardner Multiple Intelligence CS,8209,Howard Gardner Multiple Intelligence CS,45,0,0,0,0.00%
Lackawanna,119354603,Lakeland SD,6404,Lakeland JSHS,700,4,3,7,1.00%
Lackawanna,119355503,Mid Valley SD,9999,Mid Valley SD,6,0,0,0,0.00%
Lackawanna,119355503,Mid Valley SD,8304,Mid Valley Secondary Center,809,2,1,3,0.37%
Lackawanna,119356503,North Pocono SD,2446,North Pocono HS,934,2,2,4,0.43%
Lackawanna,119356503,North Pocono SD,5233,North Pocono MS,495,0,0,0,0.00%
Lackawanna,119356503,North Pocono SD,9999,North Pocono SD,15,0,0,0,0.00%
Lackawanna,119356603,Old Forge SD,2449,Old Forge JSHS,418,1,0,1,0.24%
Lackawanna,119356603,Old Forge SD,9999,Old Forge SD,7,0,0,0,0.00%
Lackawanna,119357003,Riverside SD,2496,Riverside JSHS,715,5,2,7,0.98%
Lackawanna,119357402,Scranton SD,7700,Northeast Intrmd Sch,588,0,0,0,0.00%
Lackawanna,119357402,Scranton SD,6413,Scranton HS,"1,599",44,18,62,3.88%
Lackawanna,119357402,Scranton SD,9999,Scranton SD,130,9,4,13,10.00%
Lackawanna,119357402,Scranton SD,2487,South Scranton Intrmd Sch,424,0,0,0,0.00%
Lackawanna,119357402,Scranton SD,2489,West Scranton HS,"1,122",11,7,18,1.60%
Lackawanna,119357402,Scranton SD,6791,West Scranton Intrmd Sch,492,1,3,4,0.81%
Lackawanna,119358403,Valley View SD,6775,Valley View HS,756,0,0,0,0.00%
Lackawanna,119358403,Valley View SD,7283,Valley View MS,416,0,0,0,0.00%
Lackawanna,119358403,Valley View SD,9999,Valley View SD,4,0,0,0,0.00%
Lancaster,113361303,Cocalico SD,6289,Cocalico MS,474,0,0,0,0.00%
Lancaster,113361303,Cocalico SD,9999,Cocalico SD,7,0,0,0,0.00%
Lancaster,113361303,Cocalico SD,6290,Cocalico SHS,947,5,4,9,0.95%
Lancaster,113361503,Columbia Borough SD,9999,Columbia Borough SD,12,2,0,2,16.67%
Lancaster,113361503,Columbia Borough SD,2515,Columbia HS,396,12,4,16,4.04%
Lancaster,113361503,Columbia Borough SD,8326,Columbia MS,207,0,0,0,0.00%
Lancaster,113361703,Conestoga Valley SD,9999,Conestoga Valley SD,3,0,0,0,0.00%
Lancaster,113361703,Conestoga Valley SD,2532,Conestoga Valley SHS,"1,280",8,2,10,0.78%
Lancaster,113361703,Conestoga Valley SD,2531,Gerald G Huesken MS,647,0,0,0,0.00%
Lancaster,113362203,Donegal SD,2539,Donegal HS,917,3,0,3,0.33%
Lancaster,113362203,Donegal SD,7165,Donegal JHS,463,1,0,1,0.22%
Lancaster,113362203,Donegal SD,9999,Donegal SD,8,2,1,3,37.50%
Lancaster,113362303,Eastern Lancaster County SD,9999,Eastern Lancaster County SD,2,0,0,0,0.00%
Lancaster,113362303,Eastern Lancaster County SD,7209,Garden Spot MS,493,0,0,0,0.00%
Lancaster,113362303,Eastern Lancaster County SD,2554,Garden Spot SHS,983,9,5,14,1.42%
Lancaster,113362303,Eastern Lancaster County SD,4707,New Holland Elementary,2,0,0,0,0.00%
Lancaster,113362403,Elizabethtown Area SD,6862,Elizabethtown Area MS,653,0,0,0,0.00%
Lancaster,113362403,Elizabethtown Area SD,9999,Elizabethtown Area SD,8,1,0,1,12.50%
Lancaster,113362403,Elizabethtown Area SD,2562,Elizabethtown Area SHS,"1,242",5,5,10,0.81%
Lancaster,113362603,Ephrata Area SD,9999,Ephrata Area SD,4,0,0,0,0.00%
Lancaster,113362603,Ephrata Area SD,6712,Ephrata MS,678,0,0,0,0.00%
Lancaster,113362603,Ephrata Area SD,6293,Ephrata SHS,"1,294",10,7,17,1.31%
Lancaster,113363103,Hempfield SD,5055,Centerville MS,598,0,0,0,0.00%
Lancaster,113363103,Hempfield SD,9999,Hempfield SD,6,1,0,1,16.67%
Lancaster,113363103,Hempfield SD,2578,Hempfield SHS,"2,187",13,6,19,0.87%
Lancaster,113363103,Hempfield SD,7421,Landisville MS,526,0,0,0,0.00%
Lancaster,113362940,La Academia Partnership CS,7538,La Academia Partnership Charter School,188,0,0,0,0.00%
Lancaster,113363603,Lampeter-Strasburg SD,9999,Lampeter-Strasburg SD,9,1,0,1,11.11%
Lancaster,113363603,Lampeter-Strasburg SD,2607,Lampeter-Strasburg SHS,993,5,1,6,0.60%
Lancaster,113363603,Lampeter-Strasburg SD,6297,Martin Meylin MS,473,0,0,0,0.00%
Lancaster,113364002,Lancaster SD,2599,Elizabeth R Martin El Sch,146,0,0,0,0.00%
Lancaster,113364002,Lancaster SD,2593,Hand MS,348,1,1,2,0.57%
Lancaster,113364002,Lancaster SD,9999,Lancaster SD,73,4,2,6,8.22%
Lancaster,113364002,Lancaster SD,2595,Lincoln MS,314,1,1,2,0.64%
Lancaster,113364002,Lancaster SD,2596,McCaskey Campus,"2,631",19,12,31,1.18%
Lancaster,113364002,Lancaster SD,7922,Phoenix Academy,350,48,27,75,21.43%
Lancaster,113364002,Lancaster SD,2594,Reynolds MS,319,1,1,2,0.63%
Lancaster,113364002,Lancaster SD,2600,Wheatland MS,384,1,1,2,0.52%
Lancaster,113364403,Manheim Central SD,7953,Manheim Central MS,467,0,0,0,0.00%
Lancaster,113364403,Manheim Central SD,9999,Manheim Central SD,3,0,0,0,0.00%
Lancaster,113364403,Manheim Central SD,2618,Manheim Central SHS,"1,002",7,7,14,1.40%
Lancaster,113364503,Manheim Township SD,8246,Landis Run Intermediate School,1,0,0,0,0.00%
Lancaster,113364503,Manheim Township SD,9999,Manheim Township SD,10,2,0,2,20.00%
Lancaster,113364503,Manheim Township SD,2623,Manheim Twp HS,"1,817",8,7,15,0.83%
Lancaster,113364503,Manheim Township SD,5114,Manheim Twp MS,958,1,1,2,0.21%
Lancaster,113365203,Penn Manor SD,7410,Manor Middle School,492,0,0,0,0.00%
Lancaster,113365203,Penn Manor SD,5238,Marticville MS,376,0,0,0,0.00%
Lancaster,113365203,Penn Manor SD,2633,Penn Manor HS,"1,632",4,6,10,0.61%
Lancaster,113365203,Penn Manor SD,9999,Penn Manor SD,14,1,2,3,21.43%
Lancaster,113365303,Pequea Valley SD,2649,Pequea Valley HS,470,3,2,5,1.06%
Lancaster,113365303,Pequea Valley SD,6300,Pequea Valley Intrmd Sch,230,0,0,0,0.00%
Lancaster,113365303,Pequea Valley SD,9999,Pequea Valley SD,7,1,1,2,28.57%
Lancaster,113367003,Solanco SD,2657,Smith MS,263,1,0,1,0.38%
Lancaster,113367003,Solanco SD,2658,Solanco HS,"1,078",12,2,14,1.30%
Lancaster,113367003,Solanco SD,5054,Swift MS,282,0,0,0,0.00%
Lancaster,113369003,Warwick SD,5336,Warwick MS,664,0,0,0,0.00%
Lancaster,113369003,Warwick SD,2663,Warwick SHS,"1,309",2,6,8,0.61%
Lawrence,104372003,Ellwood City Area SD,9999,Ellwood City Area SD,1,0,0,0,0.00%
Lawrence,104372003,Ellwood City Area SD,2675,Lincoln JSHS,722,4,3,7,0.97%
Lawrence,104374003,Laurel SD,2680,Laurel HS,362,0,0,0,0.00%
Lawrence,104374003,Laurel SD,8432,Laurel MS,151,0,0,0,0.00%
Lawrence,104374003,Laurel SD,9999,Laurel SD,1,0,0,0,0.00%
Lawrence,104374207,Lawrence County CTC,4940,Lawrence County CTC,368,4,2,6,1.63%
Lawrence,104375003,Mohawk Area SD,8404,Mohawk JHS,256,0,0,0,0.00%
Lawrence,104375003,Mohawk Area SD,2686,Mohawk SHS,420,0,0,0,0.00%
Lawrence,104375203,Neshannock Township SD,2689,Neshannock JSHS,581,0,1,1,0.17%
Lawrence,104375203,Neshannock Township SD,9999,Neshannock Township SD,2,0,0,0,0.00%
Lawrence,104375302,New Castle Area SD,9999,New Castle Area SD,28,3,1,4,14.29%
Lawrence,104375302,New Castle Area SD,8284,New Castle JHS,496,0,0,0,0.00%
Lawrence,104375302,New Castle Area SD,2704,New Castle SHS,761,10,5,15,1.97%
Lawrence,104376203,Shenango Area SD,9999,Shenango Area SD,1,0,0,0,0.00%
Lawrence,104376203,Shenango Area SD,2708,Shenango HS,511,2,1,3,0.59%
Lawrence,104377003,Union Area SD,2712,Union Area HS,190,0,1,1,0.53%
Lawrence,104377003,Union Area SD,7083,Union Area MS,114,0,0,0,0.00%
Lawrence,104377003,Union Area SD,9999,Union Area SD,3,0,0,0,0.00%
Lawrence,104378003,Wilmington Area SD,2721,Wilmington Area HS,371,0,0,0,0.00%
Lawrence,104378003,Wilmington Area SD,7352,Wilmington Area MS,159,0,0,0,0.00%
Lebanon,113380303,Annville-Cleona SD,2725,Annville Cleona HS,479,2,2,4,0.84%
Lebanon,113380303,Annville-Cleona SD,8178,Annville-Cleona MS,222,0,0,0,0.00%
Lebanon,113380303,Annville-Cleona SD,9999,Annville-Cleona SD,4,0,1,1,25.00%
Lebanon,113381303,Cornwall-Lebanon SD,4800,Cedar Crest HS,"1,539",14,6,20,1.30%
Lebanon,113381303,Cornwall-Lebanon SD,6301,Cedar Crest MS,792,0,0,0,0.00%
Lebanon,113382303,Eastern Lebanon County SD,6612,Eastern Lebanon Co MS,388,0,0,0,0.00%
Lebanon,113382303,Eastern Lebanon County SD,2740,Eastern Lebanon Co SHS,732,6,5,11,1.50%
Lebanon,113384603,Lebanon SD,2754,Lebanon MS,753,2,1,3,0.40%
Lebanon,113384603,Lebanon SD,9999,Lebanon SD,60,26,7,33,55.00%
Lebanon,113384603,Lebanon SD,5155,Lebanon SHS,"1,344",19,19,38,2.83%
Lebanon,113385003,Northern Lebanon SD,8310,Northern Lebanon MS,341,0,0,0,0.00%
Lebanon,113385003,Northern Lebanon SD,9999,Northern Lebanon SD,22,2,0,2,9.09%
Lebanon,113385003,Northern Lebanon SD,2760,Northern Lebanon SHS,681,9,4,13,1.91%
Lebanon,113385303,Palmyra Area SD,2765,Palmyra Area MS,604,0,0,0,0.00%
Lebanon,113385303,Palmyra Area SD,2766,Palmyra Area SHS,"1,150",9,2,11,0.96%
Lehigh,121390302,Allentown City SD,9999,Allentown City SD,126,27,12,39,30.95%
Lehigh,121390302,Allentown City SD,8412,Building 21 Allentown,460,5,2,7,1.52%
Lehigh,121390302,Allentown City SD,2792,Francis D Raub MS,596,0,0,0,0.00%
Lehigh,121390302,Allentown City SD,2791,Harrison-Morton MS,531,2,0,2,0.38%
Lehigh,121390302,Allentown City SD,2795,Louis E Dieruff HS,"1,914",36,20,56,2.93%
Lehigh,121390302,Allentown City SD,2793,South Mountain MS,777,1,1,2,0.26%
Lehigh,121390302,Allentown City SD,4929,Trexler MS,563,1,0,1,0.18%
Lehigh,121390302,Allentown City SD,2794,William Allen HS,"2,584",91,39,130,5.03%
Lehigh,121395927,Arts Academy CS,8214,Arts Academy CS,210,0,0,0,0.00%
Lehigh,121391303,Catasauqua Area SD,2797,Catasauqua MS,247,0,0,0,0.00%
Lehigh,121391303,Catasauqua Area SD,2798,Catasauqua SHS,471,8,6,14,2.97%
Lehigh,121394017,Circle of Seasons CS,8262,Circle of Seasons Charter School,61,0,0,0,0.00%
Lehigh,121392303,East Penn SD,9999,East Penn SD,17,1,0,1,5.88%
Lehigh,121392303,East Penn SD,2809,Emmaus HS,"2,868",12,7,19,0.66%
Lehigh,121392303,East Penn SD,7560,Eyer MS,604,0,0,0,0.00%
Lehigh,121392303,East Penn SD,7559,Lower Macungie MS,755,0,0,0,0.00%
Lehigh,121398065,Executive Education Academy CS,8325,Executive Education Academy Charter Scho,587,2,0,2,0.34%
Lehigh,121395526,Innovative Arts Academy CS,8371,Innovative Arts Academy CS,485,0,0,0,0.00%
Lehigh,175390169,Lincoln Leadership Academy CS,8125,Lincoln Leadership Academy Charter Schoo,348,0,0,0,0.00%
Lehigh,121394503,Northern Lehigh SD,6829,Northern Lehigh MS,233,0,0,0,0.00%
Lehigh,121394503,Northern Lehigh SD,9999,Northern Lehigh SD,7,2,0,2,28.57%
Lehigh,121394503,Northern Lehigh SD,2818,Northern Lehigh SHS,476,8,1,9,1.89%
Lehigh,121394503,Northern Lehigh SD,6727,Slatington El Sch,2,0,0,0,0.00%
Lehigh,121394603,Northwestern Lehigh SD,2821,Northwestern Lehigh HS,727,3,2,5,0.69%
Lehigh,121394603,Northwestern Lehigh SD,7353,Northwestern Lehigh MS,342,0,0,0,0.00%
Lehigh,121394603,Northwestern Lehigh SD,9999,Northwestern Lehigh SD,3,0,0,0,0.00%
Lehigh,121395103,Parkland SD,7604,Orefield MS,662,1,0,1,0.15%
Lehigh,121395103,Parkland SD,2829,Parkland HS,"3,199",5,6,11,0.34%
Lehigh,121395103,Parkland SD,9999,Parkland SD,9,0,0,0,0.00%
Lehigh,121395103,Parkland SD,7603,Springhouse MS,853,0,0,0,0.00%
Lehigh,121393330,Roberto Clemente CS,8401,Roberto Clemente CS,267,0,0,0,0.00%
Lehigh,121395603,Salisbury Township SD,5365,Salisbury MS,263,1,2,3,1.14%
Lehigh,121395603,Salisbury Township SD,2833,Salisbury SHS,523,1,0,1,0.19%
Lehigh,121395703,Southern Lehigh SD,4808,Southern Lehigh MS,503,0,0,0,0.00%
Lehigh,121395703,Southern Lehigh SD,9999,Southern Lehigh SD,8,1,0,1,12.50%
Lehigh,121395703,Southern Lehigh SD,2839,Southern Lehigh SHS,"1,114",4,3,7,0.63%
Lehigh,121397803,Whitehall-Coplay SD,2848,Whitehall HS,"1,509",3,4,7,0.46%
Lehigh,121397803,Whitehall-Coplay SD,5241,Whitehall-Coplay MS,716,0,1,1,0.14%
Lehigh,121397803,Whitehall-Coplay SD,9999,Whitehall-Coplay SD,7,2,0,2,28.57%
Luzerne,118400001,Bear Creek Community CS,7827,Bear Creek Community CS,101,0,0,0,0.00%
Luzerne,118401403,Crestwood SD,9999,Crestwood SD,5,2,0,2,40.00%
Luzerne,118401403,Crestwood SD,8446,Crestwood Secondary Campus,"1,379",1,0,1,0.07%
Luzerne,118401603,Dallas SD,5150,Dallas MS,399,0,0,0,0.00%
Luzerne,118401603,Dallas SD,2869,Dallas SHS,796,2,2,4,0.50%
Luzerne,118402603,Greater Nanticoke Area SD,8430,Greater Nanticoke Area Ed Ctr,359,0,0,0,0.00%
Luzerne,118402603,Greater Nanticoke Area SD,9999,Greater Nanticoke Area SD,14,4,1,5,35.71%
Luzerne,118402603,Greater Nanticoke Area SD,5242,Greater Nanticoke Area SHS,720,11,6,17,2.36%
Luzerne,118403003,Hanover Area SD,2891,Hanover Area JSHS,932,8,2,10,1.07%
Luzerne,118403003,Hanover Area SD,9999,Hanover Area SD,10,1,0,1,10.00%
Luzerne,118403302,Hazleton Area SD,7661,Drums El/MS,177,0,0,0,0.00%
Luzerne,118403302,Hazleton Area SD,6718,Freeland El/MS,196,0,1,1,0.51%
Luzerne,118403302,Hazleton Area SD,7348,Hazleton Area HS,"3,513",88,44,132,3.76%
Luzerne,118403302,Hazleton Area SD,9999,Hazleton Area SD,37,0,1,1,2.70%
Luzerne,118403302,Hazleton Area SD,7936,Hazleton El/MS,270,1,2,3,1.11%
Luzerne,118403302,Hazleton Area SD,6930,Heights Terrace El/MS,252,3,2,5,1.98%
Luzerne,118403302,Hazleton Area SD,8334,Maple Manor El/MS,302,0,0,0,0.00%
Luzerne,118403302,Hazleton Area SD,8245,McAdoo-Kelayres El/MS,179,0,0,0,0.00%
Luzerne,118403302,Hazleton Area SD,7340,Valley El/MS,216,1,0,1,0.46%
Luzerne,118403302,Hazleton Area SD,7569,West Hazleton El/MS,202,0,0,0,0.00%
Luzerne,118403903,Lake-Lehman SD,2924,Lake-Lehman JSHS,853,2,0,2,0.23%
Luzerne,118406003,Northwest Area SD,2958,Northwest Area HS,485,2,1,3,0.62%
Luzerne,118406003,Northwest Area SD,9999,Northwest Area SD,25,0,1,1,4.00%
Luzerne,118406602,Pittston Area SD,6385,Pittston Area MS,517,0,1,1,0.19%
Luzerne,118406602,Pittston Area SD,9999,Pittston Area SD,25,0,0,0,0.00%
Luzerne,118406602,Pittston Area SD,5058,Pittston Area SHS,"1,000",6,6,12,1.20%
Luzerne,118408707,West Side CTC,5059,West Side CTC,577,8,3,11,1.91%
Luzerne,118408852,Wilkes-Barre Area SD,3009,Elmer L Meyers JSHS,890,5,4,9,1.01%
Luzerne,118408852,Wilkes-Barre Area SD,3008,G A R Memorial JSHS,934,19,10,29,3.10%
Luzerne,118408852,Wilkes-Barre Area SD,3007,James M Coughlin JSHS,898,8,3,11,1.22%
Luzerne,118408852,Wilkes-Barre Area SD,7497,Solomon/Plains JHS,486,1,3,4,0.82%
Luzerne,118408852,Wilkes-Barre Area SD,9999,Wilkes-Barre Area SD,46,7,4,11,23.91%
Luzerne,118408852,Wilkes-Barre Area SD,8448,Wilkes-Barre Area SD STEM Academy,60,0,0,0,0.00%
Luzerne,118409203,Wyoming Area SD,6390,Wyoming Area Sec Ctr,"1,024",2,1,3,0.29%
Luzerne,118409302,Wyoming Valley West SD,6986,Wyoming Valley West MS,775,1,1,2,0.26%
Luzerne,118409302,Wyoming Valley West SD,9999,Wyoming Valley West SD,42,2,1,3,7.14%
Luzerne,118409302,Wyoming Valley West SD,6391,Wyoming Valley West SHS,"1,249",10,7,17,1.36%
Lycoming,117412003,East Lycoming SD,6364,Hughesville JSHS,761,3,0,3,0.39%
Lycoming,117414003,Jersey Shore Area SD,9999,Jersey Shore Area SD,12,1,3,4,33.33%
Lycoming,117414003,Jersey Shore Area SD,3034,Jersey Shore Area SHS,709,8,4,12,1.69%
Lycoming,117414003,Jersey Shore Area SD,3033,Jersey Shore MS,408,0,0,0,0.00%
Lycoming,117414203,Loyalsock Township SD,3037,Loyalsock Twp MS,243,0,2,2,0.82%
Lycoming,117414203,Loyalsock Township SD,4828,Loyalsock Twp SHS,485,2,4,6,1.24%
Lycoming,117415004,Montgomery Area SD,9999,Montgomery Area SD,2,0,0,0,0.00%
Lycoming,117415004,Montgomery Area SD,3040,Montgomery JSHS,370,1,0,1,0.27%
Lycoming,117415103,Montoursville Area SD,5343,C E McCall MS,345,0,0,0,0.00%
Lycoming,117415103,Montoursville Area SD,9999,Montoursville Area SD,2,0,0,0,0.00%
Lycoming,117415103,Montoursville Area SD,3045,Montoursville Area SHS,610,5,2,7,1.15%
Lycoming,117415303,Muncy SD,3048,Muncy JSHS,474,1,0,1,0.21%
Lycoming,117415303,Muncy SD,9999,Muncy SD,1,0,0,0,0.00%
Lycoming,117416103,South Williamsport Area SD,3056,South Williamsport Area JSHS,592,5,3,8,1.35%
Lycoming,117416103,South Williamsport Area SD,9999,South Williamsport Area SD,2,0,0,0,0.00%
Lycoming,117417202,Williamsport Area SD,8273,Williamsport Area MS,772,0,0,0,0.00%
Lycoming,117417202,Williamsport Area SD,6368,Williamsport Area SHS,"1,526",16,12,28,1.83%
McKean,109420803,Bradford Area SD,4691,Bradford Area HS,750,8,4,12,1.60%
McKean,109420803,Bradford Area SD,9999,Bradford Area SD,47,0,1,1,2.13%
McKean,109420803,Bradford Area SD,3092,Floyd C Fretz MS,392,0,0,0,0.00%
McKean,109422303,Kane Area SD,5245,Kane Area HS,364,4,2,6,1.65%
McKean,109422303,Kane Area SD,3100,Kane Area MS,180,0,0,0,0.00%
McKean,109426003,Otto-Eldred SD,3107,Otto-Eldred JSHS,303,2,0,2,0.66%
McKean,109426003,Otto-Eldred SD,9999,Otto-Eldred SD,4,0,0,0,0.00%
McKean,109426303,Port Allegany SD,3111,Port Allegany JSHS,396,3,0,3,0.76%
McKean,109427503,Smethport Area SD,3117,Smethport Area JSHS,355,4,0,4,1.13%
Mercer,104431304,Commodore Perry SD,6122,Commodore Perry JSHS,204,0,0,0,0.00%
Mercer,104432503,Farrell Area SD,5248,Farrell Area HS/UMS,281,1,1,2,0.71%
Mercer,104432503,Farrell Area SD,9999,Farrell Area SD,1,0,0,0,0.00%
Mercer,104432803,Greenville Area SD,3137,Greenville JSHS,627,0,2,2,0.32%
Mercer,104432903,Grove City Area SD,6125,George Jr Republic HS,225,0,0,0,0.00%
Mercer,104432903,Grove City Area SD,7316,George Jr Republic MS,68,0,0,0,0.00%
Mercer,104432903,Grove City Area SD,3145,Grove City Area HS,625,7,4,11,1.76%
Mercer,104432903,Grove City Area SD,8202,Grove City Area MS,298,0,0,0,0.00%
Mercer,104432903,Grove City Area SD,9999,Grove City Area SD,1,0,0,0,0.00%
Mercer,104433303,Hermitage SD,8069,Delahunty MS,162,0,0,0,0.00%
Mercer,104433303,Hermitage SD,9999,Hermitage SD,7,0,0,0,0.00%
Mercer,104433303,Hermitage SD,3150,Hickory HS,828,3,3,6,0.72%
Mercer,104433604,Jamestown Area SD,6126,Jamestown Area JSHS,219,0,0,0,0.00%
Mercer,104432830,Keystone Education Center CS,7506,Keystone Education Center CS,149,1,0,1,0.67%
Mercer,104433903,Lakeview SD,3155,Lakeview HS,337,4,1,5,1.48%
Mercer,104433903,Lakeview SD,7069,Lakeview MS,146,0,0,0,0.00%
Mercer,104433903,Lakeview SD,9999,Lakeview SD,1,0,0,0,0.00%
Mercer,104435003,Mercer Area SD,7792,Mercer Area MS,182,0,0,0,0.00%
Mercer,104435003,Mercer Area SD,9999,Mercer Area SD,2,0,0,0,0.00%
Mercer,104435003,Mercer Area SD,3158,Mercer Area SHS,320,2,2,4,1.25%
Mercer,104435303,Reynolds SD,3165,Reynolds JSHS,481,0,0,0,0.00%
Mercer,104435303,Reynolds SD,9999,Reynolds SD,2,0,0,0,0.00%
Mercer,104435603,Sharon City SD,8093,Sharon HS,519,6,1,7,1.35%
Mercer,104435603,Sharon City SD,8092,Sharon MS,330,0,0,0,0.00%
Mercer,104435703,Sharpsville Area SD,7387,Sharpsville Area MS,186,0,0,0,0.00%
Mercer,104435703,Sharpsville Area SD,9999,Sharpsville Area SD,1,0,0,0,0.00%
Mercer,104435703,Sharpsville Area SD,3124,Sharpsville Area SHS,394,2,1,3,0.76%
Mercer,104437503,West Middlesex Area SD,6129,West Middlesex Area JSHS,408,1,0,1,0.25%
Mercer,104437503,West Middlesex Area SD,9999,West Middlesex Area SD,1,0,0,0,0.00%
Mifflin,111444602,Mifflin County SD,8187,Mifflin Co HS,"1,165",15,12,27,2.32%
Mifflin,111444602,Mifflin County SD,8186,Mifflin Co JHS,776,1,1,2,0.26%
Mifflin,111444602,Mifflin County SD,8185,Mifflin Co MS,384,0,0,0,0.00%
Mifflin,111444602,Mifflin County SD,9999,Mifflin County SD,10,0,0,0,0.00%
Monroe,120452003,East Stroudsburg Area SD,7641,East Stroudsburg SHS North,996,8,6,14,1.41%
Monroe,120452003,East Stroudsburg Area SD,6935,East Stroudsburg SHS South,"1,332",9,2,11,0.83%
Monroe,120452003,East Stroudsburg Area SD,7366,J T Lambert Intermediate Sch,633,1,1,2,0.32%
Monroe,120452003,East Stroudsburg Area SD,7642,Lehman Intermediate Sch,470,0,0,0,0.00%
Monroe,120450003,Evergreen Community CS,7866,Evergreen Community CS,92,0,0,0,0.00%
Monroe,120455203,Pleasant Valley SD,3210,Pleasant Valley HS,"1,499",12,3,15,1.00%
Monroe,120455203,Pleasant Valley SD,7660,Pleasant Valley Intrmd Sch,1,0,0,0,0.00%
Monroe,120455203,Pleasant Valley SD,7183,Pleasant Valley MS,699,0,0,0,0.00%
Monroe,120455403,Pocono Mountain SD,3216,Pocono Mountain East HS,"1,323",7,3,10,0.76%
Monroe,120455403,Pocono Mountain SD,8010,Pocono Mountain East JHS,601,0,0,0,0.00%
Monroe,120455403,Pocono Mountain SD,9999,Pocono Mountain SD,26,0,0,0,0.00%
Monroe,120455403,Pocono Mountain SD,7738,Pocono Mountain West HS,"1,641",9,3,12,0.73%
Monroe,120455403,Pocono Mountain SD,7867,Pocono Mountain West JHS,802,0,0,0,0.00%
Monroe,120456003,Stroudsburg Area SD,9999,Stroudsburg Area SD,5,1,0,1,20.00%
Monroe,120456003,Stroudsburg Area SD,3224,Stroudsburg HS,"1,259",14,4,18,1.43%
Monroe,120456003,Stroudsburg Area SD,7593,Stroudsburg JHS,832,0,0,0,0.00%
Monroe,120456003,Stroudsburg Area SD,7839,Stroudsburg MS,403,0,0,0,0.00%
Montgomery,123460302,Abington SD,3242,Abington JHS,"1,998",0,0,0,0.00%
Montgomery,123460302,Abington SD,9999,Abington SD,10,0,0,0,0.00%
Montgomery,123460302,Abington SD,3241,Abington SHS,"1,886",4,4,8,0.42%
Montgomery,126510020,Agora Cyber CS,9999,Agora Cyber CS,7,0,0,0,0.00%
Montgomery,126510020,Agora Cyber CS,7858,Agora Cyber CS,"3,612",197,179,376,10.41%
Montgomery,123461302,Cheltenham SD,5250,Cedarbrook MS,730,0,0,0,0.00%
Montgomery,123461302,Cheltenham SD,3260,Cheltenham HS,"1,382",7,1,8,0.58%
Montgomery,123461302,Cheltenham SD,9999,Cheltenham SD,15,1,0,1,6.67%
Montgomery,123461602,Colonial SD,5077,Colonial MS,776,0,0,0,0.00%
Montgomery,123461602,Colonial SD,3333,Plymouth-Whitemarsh SHS,"1,524",4,1,5,0.33%
Montgomery,123463603,Hatboro-Horsham SD,9999,Hatboro-Horsham SD,17,0,0,0,0.00%
Montgomery,123463603,Hatboro-Horsham SD,3272,Hatboro-Horsham SHS,"1,511",1,3,4,0.26%
Montgomery,123463603,Hatboro-Horsham SD,6639,Keith Valley MS,698,0,0,0,0.00%
Montgomery,123463803,Jenkintown SD,8049,Jenkintown Middle/High School,334,0,1,1,0.30%
Montgomery,123464502,Lower Merion SD,3293,Bala-Cynwyd MS,728,0,0,0,0.00%
Montgomery,123464502,Lower Merion SD,3296,Harriton SHS,"1,240",2,0,2,0.16%
Montgomery,123464502,Lower Merion SD,3295,Lower Merion HS,"1,532",2,0,2,0.13%
Montgomery,123464502,Lower Merion SD,9999,Lower Merion SD,11,1,1,2,18.18%
Montgomery,123464502,Lower Merion SD,3294,Welsh Valley MS,708,0,0,0,0.00%
Montgomery,123464603,Lower Moreland Township SD,4960,Lower Moreland HS,770,0,1,1,0.13%
Montgomery,123464603,Lower Moreland Township SD,9999,Lower Moreland Township SD,5,0,0,0,0.00%
Montgomery,123464603,Lower Moreland Township SD,7212,Murray Avenue Sch,425,0,0,0,0.00%
Montgomery,123465303,Methacton SD,6716,Arcola Intrmd Sch,766,0,0,0,0.00%
Montgomery,123465303,Methacton SD,3305,Methacton HS,"1,524",0,1,1,0.07%
Montgomery,123465303,Methacton SD,9999,Methacton SD,20,2,0,2,10.00%
Montgomery,123465602,Norristown Area SD,3265,East Norriton MS,456,0,0,0,0.00%
Montgomery,123465602,Norristown Area SD,3321,Eisenhower MS,393,0,0,0,0.00%
Montgomery,123465602,Norristown Area SD,6729,Norristown Area HS,"1,834",27,23,50,2.73%
Montgomery,123465602,Norristown Area SD,6998,Roosevelt Altern Sch,147,10,10,20,13.61%
Montgomery,123465602,Norristown Area SD,3320,Stewart MS,381,0,0,0,0.00%
Montgomery,123465702,North Penn SD,5345,North Penn SHS,"3,005",14,7,21,0.70%
Montgomery,123465702,North Penn SD,3322,Pennbrook MS,886,0,0,0,0.00%
Montgomery,123465702,North Penn SD,3324,Penndale MS,"1,261",0,0,0,0.00%
Montgomery,123465702,North Penn SD,3323,Pennfield MS,926,0,0,0,0.00%
Montgomery,123460001,Pennsylvania Virtual CS,7687,Pennsylvania Virtual CS,"1,167",16,5,21,1.80%
Montgomery,123466103,Perkiomen Valley SD,3328,Perkiomen Valley HS,"1,803",6,3,9,0.50%
Montgomery,123466103,Perkiomen Valley SD,3326,Perkiomen Valley MS-East,484,0,0,0,0.00%
Montgomery,123466103,Perkiomen Valley SD,7794,Perkiomen Valley MS-West,385,0,0,0,0.00%
Montgomery,123466103,Perkiomen Valley SD,9999,Perkiomen Valley SD,7,1,0,1,14.29%
Montgomery,123466303,Pottsgrove SD,6746,Pottsgrove MS,513,0,0,0,0.00%
Montgomery,123466303,Pottsgrove SD,9999,Pottsgrove SD,6,0,0,0,0.00%
Montgomery,123466303,Pottsgrove SD,3338,Pottsgrove SHS,"1,031",4,6,10,0.97%
Montgomery,123466403,Pottstown SD,3346,Pottstown MS,457,0,0,0,0.00%
Montgomery,123466403,Pottstown SD,9999,Pottstown SD,61,1,0,1,1.64%
Montgomery,123466403,Pottstown SD,3348,Pottstown SHS,835,11,6,17,2.04%
Montgomery,123467103,Souderton Area SD,8062,Indian Crest MS,479,0,0,0,0.00%
Montgomery,123467103,Souderton Area SD,4722,Indian Valley MS,548,0,0,0,0.00%
Montgomery,123467103,Souderton Area SD,9999,Souderton Area SD,67,2,1,3,4.48%
Montgomery,123467103,Souderton Area SD,3354,Souderton Area SHS,"2,139",9,7,16,0.75%
Montgomery,123463370,Souderton CS Collaborative,7638,Souderton CS Collaborative,34,0,0,0,0.00%
Montgomery,123467303,Spring-Ford Area SD,9999,Spring-Ford Area SD,20,0,0,0,0.00%
Montgomery,123467303,Spring-Ford Area SD,7817,Spring-Ford MS 7th Grade Ctr,655,0,0,0,0.00%
Montgomery,123467303,Spring-Ford Area SD,7818,Spring-Ford MS 8th Grade Ctr,679,0,0,0,0.00%
Montgomery,123467303,Spring-Ford Area SD,3367,Spring-Ford SHS 9-12 Ctr,"2,536",1,0,1,0.04%
Montgomery,123467203,Springfield Township SD,9999,Springfield Township SD,8,0,0,0,0.00%
Montgomery,123467203,Springfield Township SD,3376,Springfield Twp HS,712,1,0,1,0.14%
Montgomery,123467203,Springfield Township SD,3375,Springfield Twp MS,416,0,0,0,0.00%
Montgomery,123468303,Upper Dublin SD,4943,Sandy Run MS,651,0,0,0,0.00%
Montgomery,123468303,Upper Dublin SD,5078,Upper Dublin HS,"1,291",0,0,0,0.00%
Montgomery,123468303,Upper Dublin SD,9999,Upper Dublin SD,8,0,0,0,0.00%
Montgomery,123468402,Upper Merion Area SD,9999,Upper Merion Area SD,39,0,0,0,0.00%
Montgomery,123468402,Upper Merion Area SD,3395,Upper Merion HS,"1,198",1,0,1,0.08%
Montgomery,123468402,Upper Merion Area SD,3394,Upper Merion MS,672,0,1,1,0.15%
Montgomery,123468503,Upper Moreland Township SD,3401,Upper Moreland HS,922,2,5,7,0.76%
Montgomery,123468503,Upper Moreland Township SD,5249,Upper Moreland MS,484,0,0,0,0.00%
Montgomery,123468503,Upper Moreland Township SD,9999,Upper Moreland Township SD,6,0,0,0,0.00%
Montgomery,123468603,Upper Perkiomen SD,5081,Upper Perkiomen HS,"1,045",8,4,12,1.15%
Montgomery,123468603,Upper Perkiomen SD,3406,Upper Perkiomen MS,533,0,0,0,0.00%
Montgomery,123468603,Upper Perkiomen SD,9999,Upper Perkiomen SD,7,1,0,1,14.29%
Montgomery,123469303,Wissahickon SD,3245,Wissahickon MS,748,0,0,0,0.00%
Montgomery,123469303,Wissahickon SD,9999,Wissahickon SD,26,1,0,1,3.85%
Montgomery,123469303,Wissahickon SD,3247,Wissahickon SHS,"1,465",1,2,3,0.20%
Montour,116471803,Danville Area SD,3424,Danville Area MS,351,0,0,0,0.00%
Montour,116471803,Danville Area SD,3425,Danville Area SHS,661,5,2,7,1.06%
Northampton,120480803,Bangor Area SD,3434,Bangor Area HS,981,7,9,16,1.63%
Northampton,120480803,Bangor Area SD,5257,Bangor Area MS,475,0,0,0,0.00%
Northampton,120481002,Bethlehem Area SD,9999,Bethlehem Area SD,25,7,0,7,28.00%
Northampton,120481002,Bethlehem Area SD,3464,Broughal MS,336,0,0,0,0.00%
Northampton,120481002,Bethlehem Area SD,4956,East Hills MS,739,0,0,0,0.00%
Northampton,120481002,Bethlehem Area SD,4957,Freedom HS,"1,875",12,6,18,0.96%
Northampton,120481002,Bethlehem Area SD,3465,Liberty HS,"2,665",44,21,65,2.44%
Northampton,120481002,Bethlehem Area SD,3463,Nitschmann MS,543,0,0,0,0.00%
Northampton,120481002,Bethlehem Area SD,3462,Northeast MS,509,0,1,1,0.20%
Northampton,120483302,Easton Area SD,3482,Easton Area HS,"2,875",23,17,40,1.39%
Northampton,120483302,Easton Area SD,8351,Easton Area MS,"1,464",0,0,0,0.00%
Northampton,120480002,Lehigh Valley Academy Regional CS,9999,Lehigh Valley Academy Regional CS,2,0,0,0,0.00%
Northampton,120480002,Lehigh Valley Academy Regional CS,7681,Lehigh Valley Academy Regional CS,747,1,0,1,0.13%
Northampton,120483170,Lehigh Valley Charter High School for th,7634,Lehigh Valley Charter High School for th,637,0,0,0,0.00%
Northampton,139481451,Lehigh Valley Dual Language CS,8130,Lehigh Valley Dual Language Charter Scho,84,0,0,0,0.00%
Northampton,120484803,Nazareth Area SD,3495,Nazareth Area HS,"1,549",7,2,9,0.58%
Northampton,120484803,Nazareth Area SD,3494,Nazareth Area MS,800,0,0,0,0.00%
Northampton,120484903,Northampton Area SD,3505,Northampton Area HS,"1,851",21,7,28,1.51%
Northampton,120484903,Northampton Area SD,5258,Northampton Area MS,904,0,0,0,0.00%
Northampton,120484903,Northampton Area SD,9999,Northampton Area SD,1,0,0,0,0.00%
Northampton,120485603,Pen Argyl Area SD,6439,Pen Argyl Area HS,501,2,1,3,0.60%
Northampton,120485603,Pen Argyl Area SD,9999,Pen Argyl Area SD,1,0,0,0,0.00%
Northampton,120485603,Pen Argyl Area SD,5351,Wind Gap MS,253,0,0,0,0.00%
Northampton,120486003,Saucon Valley SD,7210,Saucon Valley MS,343,0,1,1,0.29%
Northampton,120486003,Saucon Valley SD,5352,Saucon Valley SHS,750,4,2,6,0.80%
Northampton,120488603,Wilson Area SD,3522,Wilson Area HS,708,5,1,6,0.85%
Northampton,120488603,Wilson Area SD,6785,Wilson Area Intermediate Sch,366,0,0,0,0.00%
Northampton,120488603,Wilson Area SD,9999,Wilson Area SD,12,0,1,1,8.33%
Northumberland,116493503,Line Mountain SD,3532,Line Mountain HS,370,0,0,0,0.00%
Northumberland,116493503,Line Mountain SD,8286,Line Mountain MS,175,0,0,0,0.00%
Northumberland,116493503,Line Mountain SD,9999,Line Mountain SD,14,0,0,0,0.00%
Northumberland,116495003,Milton Area SD,6863,Milton Area MS,339,0,0,0,0.00%
Northumberland,116495003,Milton Area SD,9999,Milton Area SD,1,0,0,0,0.00%
Northumberland,116495003,Milton Area SD,3541,Milton HS,615,4,0,4,0.65%
Northumberland,116495103,Mount Carmel Area SD,6936,Mount Carmel Area HS,422,15,5,20,4.74%
Northumberland,116495103,Mount Carmel Area SD,8135,Mount Carmel Area JH,259,0,0,0,0.00%
Northumberland,116495103,Mount Carmel Area SD,9999,Mount Carmel Area SD,1,0,0,0,0.00%
Northumberland,116496503,Shamokin Area SD,7893,Shamokin Area HS,700,11,8,19,2.71%
Northumberland,116496503,Shamokin Area SD,7892,Shamokin Area MS,356,0,0,0,0.00%
Northumberland,116496503,Shamokin Area SD,9999,Shamokin Area SD,10,0,0,0,0.00%
Northumberland,116496603,Shikellamy SD,3569,Shikellamy HS,859,15,9,24,2.79%
Northumberland,116496603,Shikellamy SD,8372,Shikellamy MS,460,0,0,0,0.00%
Northumberland,116498003,Warrior Run SD,5103,Warrior Run HS,509,4,4,8,1.57%
Northumberland,116498003,Warrior Run SD,3575,Warrior Run MS,230,0,0,0,0.00%
Perry,115503004,Greenwood SD,6341,Greenwood HS,244,3,1,4,1.64%
Perry,115503004,Greenwood SD,7468,Greenwood MS,129,0,0,0,0.00%
Perry,115503004,Greenwood SD,9999,Greenwood SD,1,0,0,0,0.00%
Perry,115504003,Newport SD,7930,Newport HS,313,3,1,4,1.28%
Perry,115504003,Newport SD,7931,Newport MS,165,0,0,0,0.00%
Perry,115504003,Newport SD,9999,Newport SD,7,0,1,1,14.29%
Perry,115506003,Susquenita SD,3589,Susquenita HS,459,2,0,2,0.44%
Perry,115506003,Susquenita SD,7367,Susquenita MS,292,0,0,0,0.00%
Perry,115506003,Susquenita SD,9999,Susquenita SD,9,0,1,1,11.11%
Perry,115508003,West Perry SD,3597,West Perry MS,375,0,0,0,0.00%
Perry,115508003,West Perry SD,9999,West Perry SD,8,0,0,0,0.00%
Perry,115508003,West Perry SD,3596,West Perry SHS,712,3,2,5,0.70%
Philadelphia,126510015,Ad Prima CS,7825,Ad Prima CS,147,0,1,1,0.68%
Philadelphia,126510015,Ad Prima CS,9999,Ad Prima CS,2,0,0,0,0.00%
Philadelphia,126512990,Alliance for Progress CS,7543,Alliance for Progress CS,88,0,0,0,0.00%
Philadelphia,104510394,Antonia Pantoja Community CS,8031,Antonia Pantoja Community Charter School,119,0,0,0,0.00%
Philadelphia,181519176,ASPIRA Bilingual Cyber CS,8148,ASPIRA Bilingual Cyber Charter School,240,10,9,19,7.92%
Philadelphia,126510010,Belmont CS,7750,Belmont Charter School,387,0,0,0,0.00%
Philadelphia,185515523,Boys Latin of Philadelphia CS,7981,Boys Latin of Philadelphia CS,705,0,0,0,0.00%
Philadelphia,126513190,Charter High School for Architecture and,7578,Charter High School for Architecture and,552,3,0,3,0.54%
Philadelphia,126513160,Christopher Columbus CS,7575,Christopher Columbus CS,198,0,0,0,0.00%
Philadelphia,126512840,Community Academy of Philadelphia CS,7510,Community Academy of Philadelphia CS,726,1,0,1,0.14%
Philadelphia,126510011,Discovery CS,7775,Discovery Charter School,125,0,0,0,0.00%
Philadelphia,126513440,Esperanza Academy CS,7665,Esperanza Academy Charter School,"1,251",4,6,10,0.80%
Philadelphia,126513440,Esperanza Academy CS,9999,Esperanza Academy CS,2,0,0,0,0.00%
Philadelphia,126511563,Esperanza Cyber CS,8216,Esperanza Cyber CS,387,4,10,14,3.62%
Philadelphia,126513100,Eugenio Maria De Hostos CS,7564,Eugenio Maria DE Hostos CS,134,0,0,0,0.00%
Philadelphia,100510000,First Philadelphia Preparatory CS,7744,First Philadelphia Preparatory Charter S,749,1,1,2,0.27%
Philadelphia,126510021,Folk Arts-Cultural Treasures CS,7857,Folk Arts-Cultural Treasures CS,123,0,0,0,0.00%
Philadelphia,147513703,Franklin Towne Charter Elementary School,8123,Franklin Towne Charter Elementary School,210,0,0,0,0.00%
Philadelphia,126513450,Franklin Towne CHS,7666,Franklin Towne CHS,"1,192",7,6,13,1.09%
Philadelphia,126518547,Frederick Douglass Mastery CS,8150,Frederick Douglass Mastery Charter Schoo,157,0,0,0,0.00%
Philadelphia,126513270,Freire CS,7586,Freire CS,769,3,2,5,0.65%
Philadelphia,126513380,Global Leadership Academy CS,7639,Global Leadership Academy CS,151,0,0,0,0.00%
Philadelphia,126518004,Global Leadership Academy CS Southwest a,8390,Global Leadership Academy CS Southwest a,126,0,0,0,0.00%
Philadelphia,126510005,Green Woods CS,7748,Green Woods CS,123,0,0,0,0.00%
Philadelphia,126512850,Harambee Institute of Science and Techno,7511,Harambee Institute of Science and Techno,123,0,0,0,0.00%
Philadelphia,126512980,Imhotep Institute CHS,7542,Imhotep Institute CHS,571,2,1,3,0.53%
Philadelphia,126513510,Independence CS,7683,Independence CS,169,0,0,0,0.00%
Philadelphia,133513315,John B Stetson CS,8149,John B. Stetson Charter School,474,8,5,13,2.74%
Philadelphia,182514568,Keystone Academy CS,7979,Keystone Academy Charter School,131,0,0,0,0.00%
Philadelphia,126514864,KIPP DuBois CS,8358,KIPP DuBois Charter School,547,4,1,5,0.91%
Philadelphia,126510013,KIPP Philadelphia CS,7776,KIPP Philadelphia Charter School,183,0,0,0,0.00%
Philadelphia,172510793,KIPP West Philadelphia Preparatory Chart,8124,KIPP West Philadelphia Preparatory Chart,176,0,0,0,0.00%
Philadelphia,126513110,Laboratory CS,7565,Laboratory CS,93,0,0,0,0.00%
Philadelphia,126519476,Lindley Academy CS at Birney,8206,Lindley Academy CS at Birney,154,0,0,0,0.00%
Philadelphia,126513480,Mariana Bracetti Academy CS,9999,Mariana Bracetti Academy CS,5,0,0,0,0.00%
Philadelphia,126513480,Mariana Bracetti Academy CS,7672,Mariana Bracetti Academy CS,662,0,2,2,0.30%
Philadelphia,126510014,Maritime Academy CS,7777,Maritime Academy CS,461,1,1,2,0.43%
Philadelphia,126513150,MAST Community CS,7574,MAST Community CS,679,0,0,0,0.00%
Philadelphia,126513117,MaST Community CS II,8360,MaST Community CS II,91,0,0,0,0.00%
Philadelphia,126510002,Mastery CHS-Lenfest Campus,7678,Mastery CHS-Lenfest Campus,582,3,2,5,0.86%
Philadelphia,126519644,Mastery CS-Cleveland Elementary,8259,Mastery CS-Cleveland Elementary,154,0,0,0,0.00%
Philadelphia,126518795,Mastery CS-Francis D. Pastorius Elementa,8288,Mastery CS-Francis D. Pastorius Elementa,112,0,0,0,0.00%
Philadelphia,126513734,Mastery CS-Gratz Campus,8207,Mastery CS-Gratz Campus,"1,276",22,13,35,2.74%
Philadelphia,126513290,Mastery CS-Hardy Williams,7588,Mastery CS-Hardy Williams,617,1,0,1,0.16%
Philadelphia,126516457,Mastery CS-Harrity Campus,8153,Mastery CS-Harrity Campus,166,0,0,0,0.00%
Philadelphia,151514721,Mastery CS-Pickett Campus,7961,Mastery CS-Pickett Campus,750,4,2,6,0.80%
Philadelphia,126510022,Mastery CS-Shoemaker Campus,7909,Mastery CS -Shoemaker Campus,755,0,0,0,0.00%
Philadelphia,126510023,Mastery CS-Thomas Campus,7910,Mastery CS - Thomas Campus,679,1,5,6,0.88%
Philadelphia,126513230,Math Civics and Sciences CS,7582,Math Civics and Sciences CS,502,0,0,0,0.00%
Philadelphia,126519392,Memphis Street Academy CS @ JP Jones,8257,Memphis Street Academy CS @ JP Jones,407,1,0,1,0.25%
Philadelphia,126513000,Multicultural Academy CS,7546,Multicultural Academy CS,263,0,0,0,0.00%
Philadelphia,126513420,New Foundations CS,7649,New Foundations CS,993,0,0,0,0.00%
Philadelphia,126510019,Northwood Academy CS,7856,Northwood Academy CS,162,0,0,0,0.00%
Philadelphia,126513452,Olney Charter High School,8205,Olney Charter High School,"1,986",87,64,151,7.60%
Philadelphia,173515368,Pan American Academy CS,7985,Pan American Academy CS,151,0,0,0,0.00%
Philadelphia,126510004,People for People CS,7685,People for People CS,216,2,6,8,3.70%
Philadelphia,126513280,Philadelphia Academy CS,7587,Philadelphia Academy CS,632,1,0,1,0.16%
Philadelphia,126515001,Philadelphia City SD,7904,Academy at Palumbo,"1,061",5,7,12,1.13%
Philadelphia,126515001,Philadelphia City SD,7256,Adaire Alexander Sch,58,0,1,1,1.72%
Philadelphia,126515001,Philadelphia City SD,5292,Allen Dr Ethel Sch,113,0,0,0,0.00%
Philadelphia,126515001,Philadelphia City SD,3758,Allen Ethan Sch,239,6,4,10,4.18%
Philadelphia,126515001,Philadelphia City SD,6823,Amy At Martin,267,0,0,0,0.00%
Philadelphia,126515001,Philadelphia City SD,7024,Amy NW,209,0,1,1,0.48%
Philadelphia,126515001,Philadelphia City SD,3804,Anderson Add B Sch,101,0,0,0,0.00%
Philadelphia,126515001,Philadelphia City SD,3805,Arthur Chester A Sch,48,0,0,0,0.00%
Philadelphia,126515001,Philadelphia City SD,8039,Arts Academy at Benjamin Rush,647,0,2,2,0.31%
Philadelphia,126515001,Philadelphia City SD,3618,Bache-Martin Sch,82,2,0,2,2.44%
Philadelphia,126515001,Philadelphia City SD,6824,Baldi C C A MS,"1,027",4,4,8,0.78%
Philadelphia,126515001,Philadelphia City SD,8029,Barry Comm John Sch,97,1,2,3,3.09%
Philadelphia,126515001,Philadelphia City SD,3847,Bartram John - Main,552,26,24,50,9.06%
Philadelphia,126515001,Philadelphia City SD,5183,Bethune Mary McLeod Sch,117,2,2,4,3.42%
Philadelphia,126515001,Philadelphia City SD,3662,Blaine James G Sch,79,1,0,1,1.27%
Philadelphia,126515001,Philadelphia City SD,3663,Blankenburg Rudolph Sch,83,1,1,2,2.41%
Philadelphia,126515001,Philadelphia City SD,7070,Bodine William W HS,603,10,5,15,2.49%
Philadelphia,126515001,Philadelphia City SD,3620,Bregy F Amedee Sch,111,0,0,0,0.00%
Philadelphia,126515001,Philadelphia City SD,3745,Bridesburg Sch,163,0,0,0,0.00%
Philadelphia,126515001,Philadelphia City SD,3684,Brown Henry A Sch,104,1,4,5,4.81%
Philadelphia,126515001,Philadelphia City SD,3601,Bryant William C Sch,66,2,0,2,3.03%
Philadelphia,126515001,Philadelphia City SD,8332,Building 21,350,3,5,8,2.29%
Philadelphia,126515001,Philadelphia City SD,7023,Carver HS,911,5,4,9,0.99%
Philadelphia,126515001,Philadelphia City SD,3848,Central HS,"2,412",4,2,6,0.25%
Philadelphia,126515001,Philadelphia City SD,3622,Childs George W Sch,122,0,0,0,0.00%
Philadelphia,126515001,Philadelphia City SD,6767,Clemente Roberto MS,270,3,2,5,1.85%
Philadelphia,126515001,Philadelphia City SD,3782,Comegys Benjamin B Sch,91,0,0,0,0.00%
Philadelphia,126515001,Philadelphia City SD,7905,Constitution HS,385,1,3,4,1.04%
Philadelphia,126515001,Philadelphia City SD,6525,Conwell Russell MS,177,0,1,1,0.56%
Philadelphia,126515001,Philadelphia City SD,5122,Cook-Wissahickon Sch,114,1,1,2,1.75%
Philadelphia,126515001,Philadelphia City SD,7239,Cooke Jay MS,81,1,0,1,1.23%
Philadelphia,126515001,Philadelphia City SD,6996,Creative and Performing Arts,736,1,5,6,0.82%
Philadelphia,126515001,Philadelphia City SD,3706,Day Anna B Sch,97,0,2,2,2.06%
Philadelphia,126515001,Philadelphia City SD,7175,DeBurgos Bilingual Magnet MS,229,0,0,0,0.00%
Philadelphia,126515001,Philadelphia City SD,4727,Decatur Stephen Sch,240,0,0,0,0.00%
Philadelphia,126515001,Philadelphia City SD,3786,Dick William Sch,115,1,0,1,0.87%
Philadelphia,126515001,Philadelphia City SD,3763,Disston Hamilton Sch,211,0,1,1,0.47%
Philadelphia,126515001,Philadelphia City SD,3841,Dobbins AVT HS,804,16,19,35,4.35%
Philadelphia,126515001,Philadelphia City SD,3726,Dobson James Sch,52,0,0,0,0.00%
Philadelphia,126515001,Philadelphia City SD,5040,Duckrey Tanner Sch,115,1,2,3,2.61%
Philadelphia,126515001,Philadelphia City SD,3687,Dunbar Paul L Sch,45,0,0,0,0.00%
Philadelphia,126515001,Philadelphia City SD,3849,Edison HS/Fareira Skills,"1,089",78,36,114,10.47%
Philadelphia,126515001,Philadelphia City SD,7235,Farrell Louis H Sch,280,1,1,2,0.71%
Philadelphia,126515001,Philadelphia City SD,7226,Fell D Newlin Sch,179,1,2,3,1.68%
Philadelphia,126515001,Philadelphia City SD,3816,Fels Samuel HS,962,43,42,85,8.84%
Philadelphia,126515001,Philadelphia City SD,7368,Feltonville Sch of Arts & Sciences,445,0,0,0,0.00%
Philadelphia,126515001,Philadelphia City SD,3739,Finletter Thomas K Sch,172,1,0,1,0.58%
Philadelphia,126515001,Philadelphia City SD,6913,Fitler Academics Plus,81,2,0,2,2.47%
Philadelphia,126515001,Philadelphia City SD,3781,Fitzpatrick Aloysius L Sch,174,0,1,1,0.57%
Philadelphia,126515001,Philadelphia City SD,3850,Frankford HS,913,63,31,94,10.30%
Philadelphia,126515001,Philadelphia City SD,3851,Franklin Benjamin HS,380,31,19,50,13.16%
Philadelphia,126515001,Philadelphia City SD,7231,Franklin Benjamin Sch,176,0,0,0,0.00%
Philadelphia,126515001,Philadelphia City SD,6822,Franklin LC,919,12,19,31,3.37%
Philadelphia,126515001,Philadelphia City SD,3708,Franklin S Edmonds Sch,117,0,0,0,0.00%
Philadelphia,126515001,Philadelphia City SD,3818,Furness Horace HS,721,28,24,52,7.21%
Philadelphia,126515001,Philadelphia City SD,7664,Gamp,456,0,0,0,0.00%
Philadelphia,126515001,Philadelphia City SD,3625,Gideon Edward Sch,37,0,0,0,0.00%
Philadelphia,126515001,Philadelphia City SD,3843,Girls HS,766,0,24,24,3.13%
Philadelphia,126515001,Philadelphia City SD,4726,Greenberg Joseph Sch,206,0,1,1,0.49%
Philadelphia,126515001,Philadelphia City SD,5186,Greenfield Albert M Sch,118,0,0,0,0.00%
Philadelphia,126515001,Philadelphia City SD,5185,Hamilton Andrew Sch,135,1,1,2,1.48%
Philadelphia,126515001,Philadelphia City SD,7242,Harding Warren G MS,510,1,2,3,0.59%
Philadelphia,126515001,Philadelphia City SD,6528,Harrington Avery D Sch,88,1,1,2,2.27%
Philadelphia,126515001,Philadelphia City SD,5125,Hartranft John F Sch,91,1,1,2,2.20%
Philadelphia,126515001,Philadelphia City SD,3712,Henry Charles W Sch,108,0,0,0,0.00%
Philadelphia,126515001,Philadelphia City SD,5187,Heston Edward Sch,92,1,0,1,1.09%
Philadelphia,126515001,Philadelphia City SD,7229,Hill Freedman World Academy,591,2,5,7,1.18%
Philadelphia,126515001,Philadelphia City SD,3742,Hopkinson Francis Sch,198,2,2,4,2.02%
Philadelphia,126515001,Philadelphia City SD,3713,Houston Henry E Sch,100,1,1,2,2.00%
Philadelphia,126515001,Philadelphia City SD,3693,Hunter William H Sch,144,1,1,2,1.39%
Philadelphia,126515001,Philadelphia City SD,3642,Jackson Andrew Sch,91,0,1,1,1.10%
Philadelphia,126515001,Philadelphia City SD,5041,John Hancock Demonstration Sch,211,0,0,0,0.00%
Philadelphia,126515001,Philadelphia City SD,3714,John Story Jenks Academy for the Arts an,114,0,0,0,0.00%
Philadelphia,126515001,Philadelphia City SD,7963,Juniata Park Academy,258,1,0,1,0.39%
Philadelphia,126515001,Philadelphia City SD,3645,Kearny Gen Philip Sch,64,0,0,0,0.00%
Philadelphia,126515001,Philadelphia City SD,3626,Kelley William D Sch,54,2,2,4,7.41%
Philadelphia,126515001,Philadelphia City SD,8389,Kenderton El Sch,102,0,4,4,3.92%
Philadelphia,126515001,Philadelphia City SD,7852,Kensington Creative & Performing Arts HS,526,10,6,16,3.04%
Philadelphia,126515001,Philadelphia City SD,7855,Kensington Health Sciences,464,11,11,22,4.74%
Philadelphia,126515001,Philadelphia City SD,8388,Kensington HS,494,30,15,45,9.11%
Philadelphia,126515001,Philadelphia City SD,6675,King Martin Luther HS,532,55,35,90,16.92%
Philadelphia,126515001,Philadelphia City SD,3647,Kirkbride Eliza B Sch,118,0,0,0,0.00%
Philadelphia,126515001,Philadelphia City SD,3670,Lamberton Robert E Sch,86,1,1,2,2.33%
Philadelphia,126515001,Philadelphia City SD,7811,Lankenau HS,350,0,1,1,0.29%
Philadelphia,126515001,Philadelphia City SD,6530,Lea Henry C Sch,111,0,0,0,0.00%
Philadelphia,126515001,Philadelphia City SD,3664,Lewis C Cassidy Academics Plus Sch,82,1,1,2,2.44%
Philadelphia,126515001,Philadelphia City SD,3845,Lincoln HS,"1,978",82,67,149,7.53%
Philadelphia,126515001,Philadelphia City SD,3717,Lingelbach Anna L Sch,85,0,1,1,1.18%
Philadelphia,126515001,Philadelphia City SD,4732,Locke Alain Sch,87,0,0,0,0.00%
Philadelphia,126515001,Philadelphia City SD,6533,Longstreth William C Sch,86,0,1,1,1.16%
Philadelphia,126515001,Philadelphia City SD,3694,Ludlow James R Sch,56,1,1,2,3.57%
Philadelphia,126515001,Philadelphia City SD,7521,Marshall Thurgood,153,0,2,2,1.31%
Philadelphia,126515001,Philadelphia City SD,3842,Mastbaum Jules E AVTS,634,19,14,33,5.21%
Philadelphia,126515001,Philadelphia City SD,3808,Masterman Julia R Sec Sch,851,0,2,2,0.24%
Philadelphia,126515001,Philadelphia City SD,3769,Mayfair Sch,480,4,2,6,1.25%
Philadelphia,126515001,Philadelphia City SD,3648,McCall Gen George A Sch,120,0,0,0,0.00%
Philadelphia,126515001,Philadelphia City SD,3719,McCloskey John F Sch,92,0,1,1,1.09%
Philadelphia,126515001,Philadelphia City SD,3629,McDaniel Delaplaine Sch,86,0,2,2,2.33%
Philadelphia,126515001,Philadelphia City SD,5293,McKinley William Sch,94,0,0,0,0.00%
Philadelphia,126515001,Philadelphia City SD,3611,McMichael Morton Sch,76,0,0,0,0.00%
Philadelphia,126515001,Philadelphia City SD,3630,Meade Gen George C Sch,70,1,1,2,2.86%
Philadelphia,126515001,Philadelphia City SD,6768,Meehan Austin MS,669,12,8,20,2.99%
Philadelphia,126515001,Philadelphia City SD,3649,Meredith William M Sch,98,0,0,0,0.00%
Philadelphia,126515001,Philadelphia City SD,7022,Middle Years Alternative,171,0,0,0,0.00%
Philadelphia,126515001,Philadelphia City SD,3720,Mifflin Thomas Sch,52,0,0,0,0.00%
Philadelphia,126515001,Philadelphia City SD,3798,Mitchell El Sch,92,1,0,1,1.09%
Philadelphia,126515001,Philadelphia City SD,4868,Morris Robert Sch,62,0,1,1,1.61%
Philadelphia,126515001,Philadelphia City SD,3749,Morrison Andrew J Sch,142,1,0,1,0.70%
Philadelphia,126515001,Philadelphia City SD,7815,Motivation HS,378,6,4,10,2.65%
Philadelphia,126515001,Philadelphia City SD,7522,Munoz-Marin Luis,123,0,0,0,0.00%
Philadelphia,126515001,Philadelphia City SD,3650,Nebinger George W Sch,83,0,0,0,0.00%
Philadelphia,126515001,Philadelphia City SD,3855,Northeast HS,"3,483",140,75,215,6.17%
Philadelphia,126515001,Philadelphia City SD,3750,Olney El Sch,192,2,0,2,1.04%
Philadelphia,126515001,Philadelphia City SD,6960,Overbrook Edu Ctr,66,1,0,1,1.52%
Philadelphia,126515001,Philadelphia City SD,7472,Overbrook Elementary School,46,0,0,0,0.00%
Philadelphia,126515001,Philadelphia City SD,3857,Overbrook HS,481,53,27,80,16.63%
Philadelphia,126515001,Philadelphia City SD,7782,Parkway Center City Middle College,490,0,5,5,1.02%
Philadelphia,126515001,Philadelphia City SD,6548,Parkway Northwest,277,3,5,8,2.89%
Philadelphia,126515001,Philadelphia City SD,7808,Parkway West,321,5,6,11,3.43%
Philadelphia,126515001,Philadelphia City SD,7780,Paul Robeson HS for Human Services,313,1,2,3,0.96%
Philadelphia,126515001,Philadelphia City SD,7706,Penn Alexander Sch,93,0,0,0,0.00%
Philadelphia,126515001,Philadelphia City SD,8293,Penn Treaty Sch,461,7,10,17,3.69%
Philadelphia,126515001,Philadelphia City SD,3616,Penrose Sch,112,0,1,1,0.89%
Philadelphia,126515001,Philadelphia City SD,9999,Philadelphia City SD,"3,384",631,384,"1,015",29.99%
Philadelphia,126515001,Philadelphia City SD,8385,Philadelphia Learning Academy - North,40,1,2,3,7.50%
Philadelphia,126515001,Philadelphia City SD,8386,Philadelphia Learning Academy - South,87,12,5,17,19.54%
Philadelphia,126515001,Philadelphia City SD,7850,Philadelphia Military Acad at Elverson,315,7,4,11,3.49%
Philadelphia,126515001,Philadelphia City SD,5121,Potter-Thomas Sch,109,0,0,0,0.00%
Philadelphia,126515001,Philadelphia City SD,7813,Randolph A. Philip AVT HS,371,9,3,12,3.23%
Philadelphia,126515001,Philadelphia City SD,3614,Rhoads James Sch,86,0,0,0,0.00%
Philadelphia,126515001,Philadelphia City SD,8292,Rhodes E Washington Sch,174,2,3,5,2.87%
Philadelphia,126515001,Philadelphia City SD,8296,Roosevelt Theodore MS,144,4,1,5,3.47%
Philadelphia,126515001,Philadelphia City SD,3844,Roxborough HS,783,39,16,55,7.02%
Philadelphia,126515001,Philadelphia City SD,3668,Samuel Gompers Sch,75,0,0,0,0.00%
Philadelphia,126515001,Philadelphia City SD,6539,Samuel Pennypacker Sch,68,0,0,0,0.00%
Philadelphia,126515001,Philadelphia City SD,3861,Saul W B Agricultural School,514,6,4,10,1.95%
Philadelphia,126515001,Philadelphia City SD,7245,Sayre William L MS,416,29,9,38,9.13%
Philadelphia,126515001,Philadelphia City SD,7903,School of the Future,560,11,2,13,2.32%
Philadelphia,126515001,Philadelphia City SD,7906,Science Leadership Academy,499,0,1,1,0.20%
Philadelphia,126515001,Philadelphia City SD,8387,Science Leadership Academy MS,181,1,0,1,0.55%
Philadelphia,126515001,Philadelphia City SD,3653,Sharswood George Sch,115,0,0,0,0.00%
Philadelphia,126515001,Philadelphia City SD,3725,Shawmont Sch,106,1,0,1,0.94%
Philadelphia,126515001,Philadelphia City SD,3859,South Philadelphia HS,614,33,26,59,9.61%
Philadelphia,126515001,Philadelphia City SD,3654,Southwark Sch,205,1,1,2,0.98%
Philadelphia,126515001,Philadelphia City SD,3655,Spring Garden Sch,78,0,0,0,0.00%
Philadelphia,126515001,Philadelphia City SD,7234,Spruance Gilbert Sch,317,2,2,4,1.26%
Philadelphia,126515001,Philadelphia City SD,3635,Stanton Edwin M Sch,39,0,0,0,0.00%
Philadelphia,126515001,Philadelphia City SD,4963,Stearne Allen M Sch,100,0,1,1,1.00%
Philadelphia,126515001,Philadelphia City SD,3727,Steel Edward Sch,77,0,2,2,2.60%
Philadelphia,126515001,Philadelphia City SD,7255,Strawberry Mansion HS,169,14,8,22,13.02%
Philadelphia,126515001,Philadelphia City SD,7072,Swenson Arts & Technology HS,627,1,2,3,0.48%
Philadelphia,126515001,Philadelphia City SD,3657,Taggart John H Sch,90,0,0,0,0.00%
Philadelphia,126515001,Philadelphia City SD,8331,The Linc,216,7,5,12,5.56%
Philadelphia,126515001,Philadelphia City SD,8330,The Science Leadership Academy at Beeber,481,3,2,5,1.04%
Philadelphia,126515001,Philadelphia City SD,8298,The SD of Philadelphia Virtual Academy,517,27,24,51,9.86%
Philadelphia,126515001,Philadelphia City SD,8329,The U School: Innovative Lab,241,9,7,16,6.64%
Philadelphia,126515001,Philadelphia City SD,8328,The Workshop School,227,6,2,8,3.52%
Philadelphia,126515001,Philadelphia City SD,8297,Tilden William T MS,242,1,1,2,0.83%
Philadelphia,126515001,Philadelphia City SD,8294,Vare-Washington El Sch,78,0,0,0,0.00%
Philadelphia,126515001,Philadelphia City SD,8440,Vaux HS: A Big Picture School,310,6,2,8,2.58%
Philadelphia,126515001,Philadelphia City SD,3835,Wagner Gen Louis MS,334,0,2,2,0.60%
Philadelphia,126515001,Philadelphia City SD,7225,Waring Laura W Sch,57,0,0,0,0.00%
Philadelphia,126515001,Philadelphia City SD,6527,Washington George HS,"1,410",69,43,112,7.94%
Philadelphia,126515001,Philadelphia City SD,7663,Washington Grover Jr Sch,300,2,1,3,1.00%
Philadelphia,126515001,Philadelphia City SD,3615,Washington Martha Sch,68,0,0,0,0.00%
Philadelphia,126515001,Philadelphia City SD,3703,Welsh John Sch,79,0,0,0,0.00%
Philadelphia,126515001,Philadelphia City SD,3860,West Philadelphia HS,419,22,17,39,9.31%
Philadelphia,126515001,Philadelphia City SD,3728,Widener Memorial Sch,80,0,0,0,0.00%
Philadelphia,126515001,Philadelphia City SD,7253,Wilson Woodrow MS,963,13,10,23,2.39%
Philadelphia,126515001,Philadelphia City SD,7233,Ziegler William H Sch,145,0,3,3,2.07%
Philadelphia,126510009,Philadelphia Electrical & Tech CHS,7737,Philadelphia Electrical & Tech CHS,594,8,6,14,2.36%
Philadelphia,126513400,Philadelphia Performing Arts CS,7647,Philadelphia Performing Arts CS,"1,081",3,0,3,0.28%
Philadelphia,126513400,Philadelphia Performing Arts CS,9999,Philadelphia Performing Arts CS,9,0,0,0,0.00%
Philadelphia,126512960,Preparatory CS of Mathematics Science Te,7540,Preparatory CS of Mathematics Science Te,629,0,0,0,0.00%
Philadelphia,126510008,Richard Allen Preparatory CS,7684,Richard Allen Preparatory CS,251,0,0,0,0.00%
Philadelphia,126510001,Russell Byers CS,7677,Russell Byers CS,109,0,0,0,0.00%
Philadelphia,114514135,Sankofa Freedom Academy CS,8083,Sankofa Freedom Academy Charter School,302,0,0,0,0.00%
Philadelphia,114514135,Sankofa Freedom Academy CS,9999,Sankofa Freedom Academy CS,3,0,0,0,0.00%
Philadelphia,108515107,Southwest Leadership Academy CS,9999,Southwest Leadership Academy CS,1,0,0,0,0.00%
Philadelphia,108515107,Southwest Leadership Academy CS,7960,Southwest Leadership Academy CS,89,0,0,0,0.00%
Philadelphia,192518422,Tacony Academy CS,8126,Tacony Academy Charter School,526,6,7,13,2.47%
Philadelphia,126511530,TECH Freire CS,8359,TECH Freire CS,513,4,4,8,1.56%
Philadelphia,126515691,The Philadelphia CS for Arts and Science,9999,The Philadelphia CS for Arts and Science,2,0,0,0,0.00%
Philadelphia,126515691,The Philadelphia CS for Arts and Science,8252,The Philadelphia CS for Arts and Science,216,0,0,0,0.00%
Philadelphia,126512674,Universal Alcorn CS,8287,Universal Alcorn CS,88,1,0,1,1.14%
Philadelphia,126519434,Universal Audenried CS,8195,Universal Audenried Charter School,527,8,4,12,2.28%
Philadelphia,126517442,Universal Creighton CS,8251,Universal Creighton Charter School,161,0,0,0,0.00%
Philadelphia,103519376,Universal Daroff CS,8146,Universal Daroff Charter School,124,1,2,3,2.42%
Philadelphia,126513210,Universal Institute CS,7580,Universal Institute CS,156,0,0,0,0.00%
Philadelphia,126513415,Universal Vare CS,8196,Universal Vare Charter School,159,0,0,0,0.00%
Philadelphia,126513020,West Oak Lane CS,7548,West Oak Lane CS,197,0,0,0,0.00%
Philadelphia,126510007,Wissahickon CS,7724,Wissahickon CS,206,0,0,0,0.00%
Philadelphia,126510007,Wissahickon CS,9999,Wissahickon CS,1,0,0,0,0.00%
Philadelphia,126513250,Young Scholars CS,7584,Young Scholars CS,185,0,0,0,0.00%
Philadelphia,126512870,Youth Build Phila CS,7513,Youth Build Phila CS,243,38,36,74,30.45%
Pike,120522003,Delaware Valley SD,5261,Delaware Valley HS,"1,517",6,1,7,0.46%
Pike,120522003,Delaware Valley SD,3865,Delaware Valley MS,362,0,0,0,0.00%
Pike,120522003,Delaware Valley SD,7408,Dingman-Delaware MS,376,0,0,0,0.00%
Pike,120522003,Delaware Valley SD,3866,Shohola El Sch,1,0,0,0,0.00%
Pike,119648303,Wallenpaupack Area SD,4310,Wallenpaupack Area HS,"1,001",4,4,8,0.80%
Pike,119648303,Wallenpaupack Area SD,6956,Wallenpaupack Area MS,489,0,0,0,0.00%
Potter,109530304,Austin Area SD,6222,Austin Area JSHS,91,1,0,1,1.10%
Potter,109531304,Coudersport Area SD,3869,Coudersport Area JSHS,363,2,0,2,0.55%
Potter,109531304,Coudersport Area SD,9999,Coudersport Area SD,2,0,0,0,0.00%
Potter,109532804,Galeton Area SD,6223,Galeton Area Sch,144,1,2,3,2.08%
Potter,109535504,Northern Potter SD,3875,Northern Potter JSHS,219,3,4,7,3.20%
Potter,109537504,Oswayo Valley SD,3877,Oswayo Valley HS,98,0,0,0,0.00%
Potter,109537504,Oswayo Valley SD,7753,Oswayo Valley MS,58,0,0,0,0.00%
Schuylkill,129540803,Blue Mountain SD,3891,Blue Mountain HS,862,8,4,12,1.39%
Schuylkill,129540803,Blue Mountain SD,5263,Blue Mountain MS,395,0,0,0,0.00%
Schuylkill,129540803,Blue Mountain SD,9999,Blue Mountain SD,13,1,0,1,7.69%
Schuylkill,129544907,Gillingham Charter School,8161,Gillingham Charter School,110,2,0,2,1.82%
Schuylkill,129544503,Mahanoy Area SD,8403,Mahanoy Area JSHS,408,4,3,7,1.72%
Schuylkill,129544503,Mahanoy Area SD,9999,Mahanoy Area SD,15,0,1,1,6.67%
Schuylkill,129544703,Minersville Area SD,6583,Minersville Area JSHS,512,3,3,6,1.17%
Schuylkill,129545003,North Schuylkill SD,3883,North Schuylkill JSHS,968,4,4,8,0.83%
Schuylkill,129545003,North Schuylkill SD,9999,North Schuylkill SD,5,0,0,0,0.00%
Schuylkill,129546003,Pine Grove Area SD,3910,Pine Grove Area HS,522,8,2,10,1.92%
Schuylkill,129546003,Pine Grove Area SD,5262,Pine Grove Area MS,275,0,0,0,0.00%
Schuylkill,129546103,Pottsville Area SD,5265,Lengel MS,382,0,0,0,0.00%
Schuylkill,129546103,Pottsville Area SD,3924,Pottsville Area HS,941,11,6,17,1.81%
Schuylkill,129546103,Pottsville Area SD,9999,Pottsville Area SD,13,7,2,9,69.23%
Schuylkill,129546803,Saint Clair Area SD,3930,Saint Clair Area El/MS,106,0,0,0,0.00%
Schuylkill,129546803,Saint Clair Area SD,9999,Saint Clair Area SD,2,0,0,0,0.00%
Schuylkill,129547303,Schuylkill Haven Area SD,9999,Schuylkill Haven Area SD,7,0,0,0,0.00%
Schuylkill,129547303,Schuylkill Haven Area SD,3935,Schuylkill Haven MS,98,0,0,0,0.00%
Schuylkill,129547303,Schuylkill Haven Area SD,5264,Schuylkill Haven SHS,462,1,1,2,0.43%
Schuylkill,129547203,Shenandoah Valley SD,3940,Shenandoah Valley JSHS,472,2,4,6,1.27%
Schuylkill,129547203,Shenandoah Valley SD,9999,Shenandoah Valley SD,1,0,0,0,0.00%
Schuylkill,129547603,Tamaqua Area SD,7662,Tamaqua Area MS,370,0,0,0,0.00%
Schuylkill,129547603,Tamaqua Area SD,5070,Tamaqua Area SHS,690,2,4,6,0.87%
Schuylkill,129547803,Tri-Valley SD,3957,Tri-Valley JSHS,404,1,0,1,0.25%
Schuylkill,129547803,Tri-Valley SD,9999,Tri-Valley SD,1,0,0,0,0.00%
Schuylkill,129548803,Williams Valley SD,3914,Williams Valley JSHS,485,3,0,3,0.62%
Schuylkill,129548803,Williams Valley SD,9999,Williams Valley SD,3,0,0,0,0.00%
Snyder,116555003,Midd-West SD,3962,Midd-West HS,836,4,4,8,0.96%
Snyder,116555003,Midd-West SD,7799,Midd-West MS,171,0,0,0,0.00%
Snyder,116555003,Midd-West SD,9999,Midd-West SD,6,0,0,0,0.00%
Snyder,116557103,Selinsgrove Area SD,3969,Selinsgrove Area HS,838,7,4,11,1.31%
Snyder,116557103,Selinsgrove Area SD,6817,Selinsgrove Area MS,461,0,0,0,0.00%
Snyder,116557103,Selinsgrove Area SD,9999,Selinsgrove Area SD,1,0,0,0,0.00%
Somerset,108561003,Berlin Brothersvalley SD,7645,Berlin Brothersvalley MS,99,0,0,0,0.00%
Somerset,108561003,Berlin Brothersvalley SD,9999,Berlin Brothersvalley SD,1,0,0,0,0.00%
Somerset,108561003,Berlin Brothersvalley SD,6207,Berlin Brothersvalley SHS,213,1,0,1,0.47%
Somerset,108561803,Conemaugh Township Area SD,9999,Conemaugh Township Area SD,4,0,0,0,0.00%
Somerset,108561803,Conemaugh Township Area SD,3978,Conemaugh Twp Area MS/SHS,432,0,0,0,0.00%
Somerset,108565203,Meyersdale Area SD,3994,Meyersdale Area HS,276,2,1,3,1.09%
Somerset,108565203,Meyersdale Area SD,7613,Meyersdale Area MS,133,0,0,0,0.00%
Somerset,108565203,Meyersdale Area SD,9999,Meyersdale Area SD,4,0,0,0,0.00%
Somerset,108565503,North Star SD,7259,North Star East MS,184,0,0,0,0.00%
Somerset,108565503,North Star SD,3988,North Star HS,327,0,0,0,0.00%
Somerset,108566303,Rockwood Area SD,6210,Rockwood Area JSHS,354,2,1,3,0.85%
Somerset,108567004,Salisbury-Elk Lick SD,4002,Salisbury-Elk Lick JSHS,113,0,0,0,0.00%
Somerset,108567204,Shade-Central City SD,4006,Shade JSHS,198,0,0,0,0.00%
Somerset,108567404,Shanksville-Stonycreek SD,6800,Shanksville-Stonycreek HS,92,0,0,0,0.00%
Somerset,108567404,Shanksville-Stonycreek SD,7398,Shanksville-Stonycreek MS,43,0,0,0,0.00%
Somerset,108567404,Shanksville-Stonycreek SD,9999,Shanksville-Stonycreek SD,2,0,0,0,0.00%
Somerset,108567703,Somerset Area SD,8274,Somerset Area Jr-Sr HS,968,3,4,7,0.72%
Somerset,108568404,Turkeyfoot Valley Area SD,6216,Turkeyfoot Valley Area JSHS,131,0,0,0,0.00%
Somerset,108569103,Windber Area SD,4026,Windber Area HS,353,0,0,0,0.00%
Somerset,108569103,Windber Area SD,7145,Windber Area MS,181,0,0,0,0.00%
Somerset,108569103,Windber Area SD,9999,Windber Area SD,7,0,0,0,0.00%
Sullivan,117576303,Sullivan County SD,4030,Sullivan Co JSHS,282,2,0,2,0.71%
Susquehanna,119581003,Blue Ridge SD,4034,Blue Ridge HS,278,2,0,2,0.72%
Susquehanna,119581003,Blue Ridge SD,7400,Blue Ridge MS,154,0,0,0,0.00%
Susquehanna,119582503,Elk Lake SD,6418,Elk Lake JSHS,535,0,0,0,0.00%
Susquehanna,119583003,Forest City Regional SD,6419,Forest City Regional HS,324,0,0,0,0.00%
Susquehanna,119584503,Montrose Area SD,4044,Montrose Area JSHS,589,2,0,2,0.34%
Susquehanna,119584603,Mountain View SD,4049,Mountain View JSHS,430,1,2,3,0.70%
Susquehanna,119586503,Susquehanna Community SD,4054,Susquehanna Community JSHS,331,1,0,1,0.30%
Susquehanna,119586503,Susquehanna Community SD,9999,Susquehanna Community SD,23,0,0,0,0.00%
Tioga,117596003,Northern Tioga SD,4058,Cowanesque Valley JSHS,352,2,2,4,1.14%
Tioga,117596003,Northern Tioga SD,6373,Williamson SHS,547,7,3,10,1.83%
Tioga,117597003,Southern Tioga SD,4064,North Penn-Liberty JSHS,290,0,2,2,0.69%
Tioga,117597003,Southern Tioga SD,4068,North Penn-Mansfield JSHS,567,2,3,5,0.88%
Tioga,117598503,Wellsboro Area SD,4079,Rock L Butler MS,221,0,0,0,0.00%
Tioga,117598503,Wellsboro Area SD,4080,Wellsboro Area HS,480,5,5,10,2.08%
Union,116604003,Lewisburg Area SD,4665,Donald H Eichhorn MS,301,1,0,1,0.33%
Union,116604003,Lewisburg Area SD,9999,Lewisburg Area SD,4,0,0,0,0.00%
Union,116604003,Lewisburg Area SD,4085,Lewisburg HS,619,1,3,4,0.65%
Union,116605003,Mifflinburg Area SD,6809,Mifflinburg Area MS,282,0,0,0,0.00%
Union,116605003,Mifflinburg Area SD,4091,Mifflinburg Area SHS,620,8,3,11,1.77%
Venango,106611303,Cranberry Area SD,4098,Cranberry Area JSHS,515,0,0,0,0.00%
Venango,106612203,Franklin Area SD,4106,Franklin Area JSHS,857,2,7,9,1.05%
Venango,106612203,Franklin Area SD,9999,Franklin Area SD,19,4,2,6,31.58%
Venango,106616203,Oil City Area SD,7215,Oil City Area MS,320,0,0,0,0.00%
Venango,106616203,Oil City Area SD,9999,Oil City Area SD,9,0,0,0,0.00%
Venango,106616203,Oil City Area SD,4931,Oil City SHS,574,3,5,8,1.39%
Venango,106617203,Titusville Area SD,6168,Pleasantville El Sch,3,0,0,0,0.00%
Venango,106617203,Titusville Area SD,9999,Titusville Area SD,2,0,0,0,0.00%
Venango,106617203,Titusville Area SD,7601,Titusville MS,300,0,0,0,0.00%
Venango,106617203,Titusville Area SD,1668,Titusville SHS,539,5,6,11,2.04%
Venango,106618603,Valley Grove SD,4126,Rocky Grove JSHS,387,2,2,4,1.03%
Warren,105620001,Tidioute Community CS,7833,Tidioute Community CS,142,0,0,0,0.00%
Warren,105628302,Warren County SD,4148,Beaty-Warren MS,347,0,2,2,0.58%
Warren,105628302,Warren County SD,4143,Eisenhower M/HS,411,4,1,5,1.22%
Warren,105628302,Warren County SD,4146,Sheffield M/HS,236,0,3,3,1.27%
Warren,105628302,Warren County SD,4149,Warren Area HS,696,12,5,17,2.44%
Warren,105628302,Warren County SD,4135,Youngsville MS/HS,339,2,3,5,1.47%
Washington,101630504,Avella Area SD,4165,Avella Area JSHS,249,0,0,0,0.00%
Washington,101630504,Avella Area SD,9999,Avella Area SD,2,0,0,0,0.00%
Washington,101630903,Bentworth SD,7988,Bentworth MS,188,0,0,0,0.00%
Washington,101630903,Bentworth SD,9999,Bentworth SD,1,0,0,0,0.00%
Washington,101630903,Bentworth SD,4188,Bentworth SHS,344,1,1,2,0.58%
Washington,101631003,Bethlehem-Center SD,5267,Bethlehem-Center MS,163,0,0,0,0.00%
Washington,101631003,Bethlehem-Center SD,9999,Bethlehem-Center SD,1,0,0,0,0.00%
Washington,101631003,Bethlehem-Center SD,4181,Bethlehem-Center SHS,386,2,0,2,0.52%
Washington,101631203,Burgettstown Area SD,9999,Burgettstown Area SD,2,0,0,0,0.00%
Washington,101631203,Burgettstown Area SD,4195,Burgettstown MS/HS,483,2,1,3,0.62%
Washington,101631503,California Area SD,6939,California Area MS,118,0,0,0,0.00%
Washington,101631503,California Area SD,4203,California Area SHS,276,1,1,2,0.72%
Washington,101631703,Canon-McMillan SD,9999,Canon-McMillan SD,17,0,0,0,0.00%
Washington,101631703,Canon-McMillan SD,4217,Canon-McMillan SHS,"1,702",0,3,3,0.18%
Washington,101631703,Canon-McMillan SD,7217,Canonsburg MS,834,0,1,1,0.12%
Washington,101631803,Charleroi SD,4715,Charleroi Area HS,434,5,2,7,1.61%
Washington,101631803,Charleroi SD,7157,Charleroi Area MS,236,0,0,0,0.00%
Washington,101631903,Chartiers-Houston SD,4235,Chartiers-Houston JSHS,521,1,0,1,0.19%
Washington,101631903,Chartiers-Houston SD,9999,Chartiers-Houston SD,11,0,0,0,0.00%
Washington,101632403,Fort Cherry SD,4242,Fort Cherry JSHS,493,4,1,5,1.01%
Washington,101632403,Fort Cherry SD,9999,Fort Cherry SD,13,0,0,0,0.00%
Washington,101633903,McGuffey SD,4249,McGuffey HS,469,3,2,5,1.07%
Washington,101633903,McGuffey SD,6976,McGuffey MS,252,0,0,0,0.00%
Washington,101633903,McGuffey SD,9999,McGuffey SD,14,0,0,0,0.00%
Washington,101636503,Peters Township SD,5083,Peters Twp HS,"1,371",0,0,0,0.00%
Washington,101636503,Peters Township SD,4256,Peters Twp MS,610,0,0,0,0.00%
Washington,101637002,Ringgold SD,8103,Ringgold MS,433,0,0,0,0.00%
Washington,101637002,Ringgold SD,9999,Ringgold SD,8,1,0,1,12.50%
Washington,101637002,Ringgold SD,7019,Ringgold SHS,851,4,1,5,0.59%
Washington,101638003,Trinity Area SD,9999,Trinity Area SD,5,0,0,0,0.00%
Washington,101638003,Trinity Area SD,6638,Trinity MS,523,0,0,0,0.00%
Washington,101638003,Trinity Area SD,6012,Trinity SHS,"1,003",7,2,9,0.90%
Washington,101638803,Washington SD,4286,Washington HS,433,6,3,9,2.08%
Washington,101638803,Washington SD,6912,Washington Junior High School,194,0,0,0,0.00%
Washington,101638803,Washington SD,9999,Washington SD,3,0,0,0,0.00%
Wayne,119648703,Wayne Highlands SD,6424,Damascus Area Sch,66,0,0,0,0.00%
Wayne,119648703,Wayne Highlands SD,4295,Honesdale HS,780,5,3,8,1.03%
Wayne,119648703,Wayne Highlands SD,6425,Preston Sch,38,0,0,0,0.00%
Wayne,119648703,Wayne Highlands SD,6865,Wayne Highlands MS,294,0,0,0,0.00%
Wayne,119648703,Wayne Highlands SD,9999,Wayne Highlands SD,49,0,0,0,0.00%
Wayne,119648903,Western Wayne SD,6704,Western Wayne HS,567,7,4,11,1.94%
Wayne,119648903,Western Wayne SD,7341,Western Wayne MS,262,0,1,1,0.38%
Wayne,119648903,Western Wayne SD,9999,Western Wayne SD,10,0,0,0,0.00%
Westmoreland,107650603,Belle Vernon Area SD,4930,Belle Vernon Area HS,767,7,4,11,1.43%
Westmoreland,107650603,Belle Vernon Area SD,8269,Belle Vernon Area MS,386,0,0,0,0.00%
Westmoreland,107650603,Belle Vernon Area SD,9999,Belle Vernon Area SD,6,0,0,0,0.00%
Westmoreland,107650703,Burrell SD,4340,Burrell HS,598,2,0,2,0.33%
Westmoreland,107650703,Burrell SD,9999,Burrell SD,9,1,0,1,11.11%
Westmoreland,107650703,Burrell SD,4339,Charles A Huston MS,294,0,0,0,0.00%
Westmoreland,107651603,Derry Area SD,4351,Derry Area MS,320,0,0,0,0.00%
Westmoreland,107651603,Derry Area SD,9999,Derry Area SD,16,0,0,0,0.00%
Westmoreland,107651603,Derry Area SD,4352,Derry Area SHS,569,1,2,3,0.53%
Westmoreland,107653040,Dr Robert Ketterer CS Inc,7550,Dr Robert Ketterer CS Inc,174,3,2,5,2.87%
Westmoreland,107652603,Franklin Regional SD,7602,Franklin Regional MS,515,0,0,0,0.00%
Westmoreland,107652603,Franklin Regional SD,9999,Franklin Regional SD,7,0,0,0,0.00%
Westmoreland,107652603,Franklin Regional SD,4360,Franklin Regional SHS,"1,137",0,1,1,0.09%
Westmoreland,107653102,Greater Latrobe SD,6957,Greater Latrobe JHS,587,0,0,0,0.00%
Westmoreland,107653102,Greater Latrobe SD,9999,Greater Latrobe SD,33,1,1,2,6.06%
Westmoreland,107653102,Greater Latrobe SD,4845,Greater Latrobe SHS,"1,264",0,4,4,0.32%
Westmoreland,107653203,Greensburg Salem SD,9999,Greensburg Salem SD,26,0,0,0,0.00%
Westmoreland,107653203,Greensburg Salem SD,4373,Greensburg-Salem HS,782,9,5,14,1.79%
Westmoreland,107653203,Greensburg Salem SD,4372,Greensburg-Salem MS,414,0,0,0,0.00%
Westmoreland,107653802,Hempfield Area SD,7268,Harrold MS,288,0,0,0,0.00%
Westmoreland,107653802,Hempfield Area SD,9999,Hempfield Area SD,16,2,0,2,12.50%
Westmoreland,107653802,Hempfield Area SD,4404,Hempfield Area SHS,"1,789",13,6,19,1.06%
Westmoreland,107653802,Hempfield Area SD,7269,Wendover MS,311,0,0,0,0.00%
Westmoreland,107653802,Hempfield Area SD,7270,West Hempfield MS,257,0,0,0,0.00%
Westmoreland,107654103,Jeannette City SD,9999,Jeannette City SD,11,0,0,0,0.00%
Westmoreland,107654103,Jeannette City SD,8421,Jeannette HS,447,7,0,7,1.57%
Westmoreland,107654403,Kiski Area SD,4431,Kiski Area HS,"1,120",4,3,7,0.63%
Westmoreland,107654403,Kiski Area SD,7189,Kiski Area IHS,551,0,0,0,0.00%
Westmoreland,107654403,Kiski Area SD,9999,Kiski Area SD,26,0,0,0,0.00%
Westmoreland,107654903,Ligonier Valley SD,4442,Ligonier Valley HS,488,1,0,1,0.20%
Westmoreland,107654903,Ligonier Valley SD,4440,Ligonier Valley MS,238,0,0,0,0.00%
Westmoreland,107654903,Ligonier Valley SD,9999,Ligonier Valley SD,12,0,0,0,0.00%
Westmoreland,107655803,Monessen City SD,9999,Monessen City SD,2,0,0,0,0.00%
Westmoreland,107655803,Monessen City SD,7399,Monessen MS,109,0,0,0,0.00%
Westmoreland,107655803,Monessen City SD,6181,Monessen SHS,231,5,1,6,2.60%
Westmoreland,107655903,Mount Pleasant Area SD,4458,Mount Pleasant Area HS,595,2,8,10,1.68%
Westmoreland,107655903,Mount Pleasant Area SD,7791,Mount Pleasant Area JHS,326,0,0,0,0.00%
Westmoreland,107655903,Mount Pleasant Area SD,9999,Mount Pleasant Area SD,6,0,0,0,0.00%
Westmoreland,107656303,New Kensington-Arnold SD,8323,Valley JSHS,823,12,7,19,2.31%
Westmoreland,107656502,Norwin SD,4482,Norwin MS,864,0,0,0,0.00%
Westmoreland,107656502,Norwin SD,9999,Norwin SD,11,0,0,0,0.00%
Westmoreland,107656502,Norwin SD,4717,Norwin SHS,"1,609",4,1,5,0.31%
Westmoreland,107657103,Penn-Trafford SD,4492,Penn MS,388,0,0,0,0.00%
Westmoreland,107657103,Penn-Trafford SD,6648,Penn Trafford HS,"1,299",1,4,5,0.38%
Westmoreland,107657103,Penn-Trafford SD,9999,Penn-Trafford SD,18,0,0,0,0.00%
Westmoreland,107657103,Penn-Trafford SD,6189,Trafford MS,220,0,0,0,0.00%
Westmoreland,107657503,Southmoreland SD,8102,Southmoreland MS,294,0,0,0,0.00%
Westmoreland,107657503,Southmoreland SD,9999,Southmoreland SD,14,0,1,1,7.14%
Westmoreland,107657503,Southmoreland SD,6191,Southmoreland SHS,561,7,5,12,2.14%
Westmoreland,107658903,Yough SD,4508,Yough Intrmd/MS Sch,280,0,0,0,0.00%
Westmoreland,107658903,Yough SD,9999,Yough SD,15,0,0,0,0.00%
Westmoreland,107658903,Yough SD,4735,Yough SHS,639,7,3,10,1.56%
Wyoming,119665003,Lackawanna Trail SD,4524,Lackawanna Trail El Ctr,1,0,0,0,0.00%
Wyoming,119665003,Lackawanna Trail SD,4528,Lackawanna Trail JSHS,475,1,1,2,0.42%
Wyoming,118667503,Tunkhannock Area SD,5271,Tunkhannock HS,920,0,3,3,0.33%
Wyoming,118667503,Tunkhannock Area SD,8444,Tunkhannock STEM Academy,192,0,0,0,0.00%
York,112671303,Central York SD,4545,Central York HS,"1,809",10,3,13,0.72%
York,112671303,Central York SD,4544,Central York MS,941,0,0,0,0.00%
York,112671303,Central York SD,9999,Central York SD,10,0,0,0,0.00%
York,112673300,Crispus Attucks CS,7624,Crispus Attucks CS,97,35,16,51,52.58%
York,112671603,Dallastown Area SD,6598,Dallastown Area MS,"1,061",0,0,0,0.00%
York,112671603,Dallastown Area SD,9999,Dallastown Area SD,35,1,3,4,11.43%
York,112671603,Dallastown Area SD,4553,Dallastown Area SHS,"1,928",5,2,7,0.36%
York,112671803,Dover Area SD,4558,Dover Area HS,"1,004",5,3,8,0.80%
York,112671803,Dover Area SD,6283,Dover Area Intrmd Sch,567,0,0,0,0.00%
York,112672203,Eastern York SD,4564,Eastern York HS,713,7,6,13,1.82%
York,112672203,Eastern York SD,7439,Eastern York MS,406,0,0,0,0.00%
York,112672203,Eastern York SD,9999,Eastern York SD,1,0,0,0,0.00%
York,112672803,Hanover Public SD,4570,Hanover MS,322,0,0,0,0.00%
York,112672803,Hanover Public SD,9999,Hanover Public SD,23,0,1,1,4.35%
York,112672803,Hanover Public SD,4571,Hanover SHS,519,8,3,11,2.12%
York,112674403,Northeastern York SD,4578,Northeastern MS,647,0,0,0,0.00%
York,112674403,Northeastern York SD,4577,Northeastern SHS,"1,153",9,8,17,1.47%
York,115674603,Northern York County SD,6345,Northern HS,"1,034",7,4,11,1.06%
York,115674603,Northern York County SD,6346,Northern MS,533,0,0,0,0.00%
York,115674603,Northern York County SD,9999,Northern York County SD,8,0,0,0,0.00%
York,112675503,Red Lion Area SD,8050,Larry J. Macaluso El Sch,1,0,0,0,0.00%
York,112675503,Red Lion Area SD,4597,Red Lion Area JHS,880,0,0,0,0.00%
York,112675503,Red Lion Area SD,9999,Red Lion Area SD,21,1,0,1,4.76%
York,112675503,Red Lion Area SD,4598,Red Lion Area SHS,"1,483",13,9,22,1.48%
York,112676203,South Eastern SD,4602,Kennard-Dale HS,758,5,2,7,0.92%
York,112676203,South Eastern SD,7699,South Eastern MS,399,0,0,0,0.00%
York,112676203,South Eastern SD,9999,South Eastern SD,9,1,2,3,33.33%
York,112676403,South Western SD,6641,Markle Intrmd Sch,683,0,0,0,0.00%
York,112676403,South Western SD,9999,South Western SD,17,2,0,2,11.76%
York,112676403,South Western SD,4608,South Western SHS,"1,251",3,2,5,0.40%
York,112676503,Southern York County SD,6286,Southern MS,494,0,0,0,0.00%
York,112676503,Southern York County SD,9999,Southern York County SD,5,0,1,1,20.00%
York,112676503,Southern York County SD,4614,Susquehannock HS,950,1,3,4,0.42%
York,112676703,Spring Grove Area SD,4623,Spring Grove Area HS,"1,175",5,5,10,0.85%
York,112676703,Spring Grove Area SD,6725,Spring Grove Area MS,673,0,0,0,0.00%
York,112676703,Spring Grove Area SD,9999,Spring Grove Area SD,3,0,0,0,0.00%
York,115219002,West Shore SD,1741,Allen MS,363,0,0,0,0.00%
York,115219002,West Shore SD,1732,Cedar Cliff HS,"1,290",13,5,18,1.40%
York,115219002,West Shore SD,7395,Crossroads MS,450,0,0,0,0.00%
York,115219002,West Shore SD,8276,New Cumberland MS,398,0,0,0,0.00%
York,115219002,West Shore SD,4704,Red Land SHS,"1,107",6,2,8,0.72%
York,115219002,West Shore SD,9999,West Shore SD,27,0,0,0,0.00%
York,112678503,West York Area SD,6705,West York Area HS,888,5,2,7,0.79%
York,112678503,West York Area SD,7286,West York Area MS,469,0,0,0,0.00%
York,112678503,West York Area SD,9999,West York Area SD,4,0,0,0,0.00%
York,189670676,York Academy Regional CS,8131,York Academy Regional Charter School,262,0,0,0,0.00%
York,112679002,York City SD,8237,Davis Sch,100,0,0,0,0.00%
York,112679002,York City SD,8238,Devers Sch,139,0,0,0,0.00%
York,112679002,York City SD,8398,Edgar Fahs Smith STEAM Academy,99,0,0,0,0.00%
York,112679002,York City SD,8239,Ferguson Sch,166,1,0,1,0.60%
York,112679002,York City SD,8240,Goode Sch,125,0,0,0,0.00%
York,112679002,York City SD,8291,Hannah Penn,120,0,0,0,0.00%
York,112679002,York City SD,8241,Jackson Sch,110,1,0,1,0.91%
York,112679002,York City SD,8242,McKinley Sch,160,2,2,4,2.50%
York,112679002,York City SD,4647,William Penn SHS,"1,441",54,34,88,6.11%
York,112679002,York City SD,9999,York City SD,22,4,0,4,18.18%
York,112679107,York Co School of Technology,5168,York Co School of Technology,"1,698",4,4,8,0.47%
York,112679403,York Suburban SD,4657,York Suburban MS,488,0,0,0,0.00%
York,112679403,York Suburban SD,9999,York Suburban SD,19,2,1,3,15.79%
York,112679403,York Suburban SD,4658,York Suburban SHS,"1,005",5,3,8,0.80%
Overall,,,,,"812,630","6,842","4,823","11,665",1.44%
"Apr 7, 2021
															8:58:11 AM",,,,- 5 -,,,www.pimsreports.pa.gov,,
,,,,,,,,,
